Электростанция	Вырабатывает электроэнергию, которая потребляется всеми постройками на планете.
Лаборатория	В лаборатории ученые изучают планету и собирают нужные ресурсы.
Ракетная база	Наносит урон вражеским кораблям на орбите планеты.
Климатическая станция	Терраморфирует планету, что обеспечивает разворачивание нужного направления производства.
Склад	Обеспечивает хранение ресурсов на планете.
Ксеноновая скважина	Добывает ксенон из недр планеты.
Титановый рудник	Добывает титан из ильменитового месторождения.
Кремниевый рудник	Добывает кремний из кварцитного месторождения.
Кристаллический резак	Добывает антикристаллы из кристаллических разломов.
Ферма	Производит продовольствие.
Электротехнический комбинат	Производит электронику.
Горнорудный комбинат	Производит металл.
Антипротонный ускоритель	Производит антиматерию.
Плазмотрон	Производит плазму.
Город	Обеспечивает проживание большому количеству населения.
Сборочный комплекс	Производит сборку модулей.
Научный центр	Производит кварковые ядра.
Термоядерный поляризатор	Производит топливо.
Завод усилителей	Производит все виды усилителей.
Завод брони	Производит все виды брони.
Завод дроидов	Производит все виды дроидов.
Машиностроительная фабрика	Производит технику, которая используется для снабжения планет.
Университет	Обучает инженеров, которые обеспечивают работу всех зданий на планетах.
Миностроительный завод	Производит орбитальные мины.
Академия механиков	Готовит механиков, которые эффективно управляют флотом.
Академия навигаторов	Готовит навигаторов, которые эффективно управляют флотом.