  FormatDate	<D> <M> <Y>
  Select	Выбрать
  Build	Построить
  BuildFlagship	Построить флагман для
  Count	Количество
  ItemComplete	Завершено
  Price	Цена
  Sum	Сумма
  Atm	Атмосфера
  Tmp	Температура
  Tec	Тектоника
  CntDestroy	Уничтоженных
  Mass	Масса
  Fuel	Топливо
  Armour	Броня
  ShieldReduce	Рассеивание
  MaxHP	Структура
  MaxShield	Щит
  ValShield	Напряжение
  IncShield	Регенерация
  ValBarrier	Барьер
  Damage	Повреждения
  Repair	Ремонт
  Power	Ударная сила
  PowerCannon	Пушка
  PowerLaser	Лазер
  PowerMissile	Ракеты
  PowerTransiver	Трансивер
  Accuracy	Точность
  Cost	Стоимость
  Planet	Малая планета
  PlanetLarge	Обитаемая планета
  Sun	Звезда
  Pulsar	Пульсар
  PulsarOn	Активный
  PulsarOff	Пассивный
  PulsarTimeOn	Активируется через
  PulsarTimeOff	Деактивируется через
  Gigant	Газовый гигант
  PlanetTini	Карликовая планета
  PlanetRich	Радужный мир
  Radiation	Радиация
  RadiationLow	Слабая радиация
  ThreatSun	Радиационная угроза
  ThreatGigant	Астероидная угроза
  ThreatTini	Астероидная угроза
  Wormhole	Червоточина
  WormholeRoam	Блуждающая червоточина
  WormholePrepare	Стабилизируется
  WormholeOpen	Стабилизирована
  WormholeClose	Дестабилизирована
  WormholeOpenTime	Время до открытия
  WormholeCloseTime	Время до закрытия
  Module	Модули
  Res	Модули
  ResInc	Объем производства
  BuildItem	Специализация
  Level	Инфраструктура
  PlanetRefuel	Пополнение топлива
  PlanetNoCapture	(Захват невозможен)
  PlanetNoMove	(Перелет невозможен)
  Cancel	Отменить
  Max	MAX
  Homeworld	Столица
  Citadel	Цитадель
  Empire	Империя
  Enclave	Анклав
  Colony	Колония
  Base	База
  District	Сфера
  Outpost	Форпост
  DistrictPlanetCnt	Планет в вашей сфере
  MaxEnclaveTarget	Цель	 Захват <Val>% планет.
  MaxEnclaveTime	До окончания
  OccupyHomeworldTime	Прикрытие
  NewHomeworld	Столица новой империи
  Phantom	Фантом
  MiniMapLarge	Большая карта
  MiniMapSmall	Малая карта
  MiniMapPlanet	Планеты
  MiniMapShowPlanet	Отобразить планеты
  MiniMapHidePlanet	Скрыть планеты
  MiniMapShip	Корабли
  MiniMapShowShip	Отобразить корабли
  MiniMapHideShip	Скрыть корабли
  MiniMapScaleDefault	Масштаб по умолчанию
  MiniMapRes	Ресурсы
  MiniMapAllShip	Все корабли
  MiniMapPlayerShip	Корабли игрока
  FormMiniMapWormholes	Червоточины
  FormMiniMapGravitor	Гравиторы
  FormMiniMapColony	Колонии
  FormMiniMapMine	Мины
  FormMiniMapNoCapture	Нельзя захватывать
  Owner	Владелец
  Load	Загрузка
  Neutral	Нейтральная
  User	Игрок
  RewardExp	Награда за захват
  Exp	опыта
  UserPlanetCnt	Всего планет
  EmpirePlanetCnt	Планет в империи
  EnclavePlanetCnt	Планет в анклаве
  ColonyPlanetCnt	Планет в колониях
  GravitorSciCnt	Научных гравиторов
  StatMineCnt	Заминированных слотов
  UserShipCnt	Всего кораблей
  UserShipMassDefMax	Предельная масса обороны
  UserShipMassDef	Масса обороны
  UserShipMassAtkMax	Предельная масса нападения
  UserShipMassAtk	Масса нападения
  UserRating	Рейтинг развития
  CombatRating	Боевой рейтинг
  UserScore	Боевая слава
  UserRest	Очки отдыха
  UserExp	Очки опыта
  UserKlingDestroyCnt	Клисан уничтожено
  Stat	Статистика"  
  StatUpdateTime	Расчет и обновление статистики происходит раз в минуту.
  MsgNewEmpire	<p align='center'><font color='#ff0000'>ВНИМАНИЕ!</font> Старая империя будет уничтожена. Вы действительно хотите основать новую империю?</p>
  ButFind	Найти
  ButClose	Закрыть
  ButCancel	Отменить
  ButChange	Обменять
  ButSave	Сохранить
  RandomFon	Случайный
  Split	Распределить
  ButRes	Ресурсы
  ButTech	Технологии
  ButGive	Снарядить
  ButDestroy	Взорвать
  ButDestroyPlanet	Взорвать планетоид
  QueryDestroyPlanet	[justify]Вы можете взорвать планетоид в своем созвездии в том случае, если планеты не образуют отдельной группы. Невозможно взорвать пульсар и червоточину. Вместе с уничтожением планетоида, будут уничтожены все постройки, корабли, товары.[br]Стоимость операции <Cost> cr. и <QC> кварковых ядер размещённых на орбите в трюме транспорта. [br][br]Вы уверены, что хотите взорвать планетоид?[/justify]
  ButExtract	Собирать	 Водород
  ButPolar	Поляризация щита (E)
  ButPolar2	Поляризация щита
  ButTransiver	Трансиверный лазер (E)
  ButSiege	Осадный режим (E)
  ButNanits	Наниты (E)
  ButNoToBattle	Походный режим (Q)
  ButAIRoute	Следовать маршруту (C)" 
  ButAIAttack	Атаковать (Z)
  ButLink	Цель (X)
  AutoBuild	Автоматическая постройка
  ButBomb	Аннигиляция
  ButSetBlasting	Заминировать
  ButClearBlasting	Разминировать
  ButRecharge	Зарядник - Восстановить щиты
  ButConstructor	Конструктор - Восстановить структуру
  ButInvu	Протонный щит
  ButGravitor	Гравитор
  ButGravitorOn	Активировать гравитор" 
  ButGravitorOff	Деактивировать гравитор" 
  ButGravitorSci	Научный гравитор
  ButGravitorFlagship	Флагманский гравитор
  ButEject	Перебросить флот
  ButMine	Устанавливать мины
  ButMineDestroy	Подорвать мины
  ButMineDestroyQuery	Вы уверены, что хотите подорвать мины на этой орбите этой планеты?
  ButTransition	Квантовый переход (E)
  ButBarrier	Освободить барьер (E)
  ButExchange	Квантовый переход
  ButCancelBuild	Отменить постройку
  ButLeave	Покинуть планету
  ButDestroyEmpire	Уничтожить империю
  ButChangeRace	Сменить расу
  DestroyEmpireQuery	Для уничтожения империи введите слово 'DELETE'
  DestroyEmpireCom	После уничтожения вам начисляется остаток очков развития,\nна которые вы сможете построить новую империю.\nТакже при уничтожении теряются две технологии.\nИмперию нельзя уничтожить, если в созвездии есть враг.
  DestroyEmpire	Уничтожить
  ButLoad	Загрузить модули
  ButUnloadModule	Выгрузить модули
  ButUnload	Выгрузить
  ButSack	Грабить модули
  ButRefuel	Заправить
  ButDropEq	Выбросить оборудование
  JumpWormhole	На другую сторону червоточины (пробел)
  Eq	Оборудование
  FormResCaption	Ресурсы империи
  FormResItemBuildQuery	Вы действительно хотите создать оборудование ?
  StatResCnt	В наличии
  StatResInc	Приход
  StatResDec	Снабжение
  BonusPower	Ударная сила
  BonusArmour	Броня
  BonusRepair	Ремонт
  MinePower	Урон
  ChangeFrom	Обменять
  ChangeTo	на
  OpComplate	Операция успешно выполнена.
  ResSupplyNone	отсутствует
  ResSupplyLow	низкое
  ResSupplyNormal	нормальное
  ResSupplyH	высокое
  BuildTime	Построится через
  PortalTime	До перехода через портал
  EjectTime	До переброски
  BombTime	Аннигиляция через
  BlastingTime	Подрыв через
  ButPlusar	Инжекторы
  ButBase	Основать базу
  QueryBase	База - это центр вашей территории в данном созвездии. Для основания базы требуется [clr]<Val>[/clr] cr.[br][br]Вы действительно хотите основать базу на этой планете?
  ButCitadel	Основать цитадель
  QueryCitadel	Цитадель - это центр вашего анклава за пределами империи. Для основания цитадели требуется [clr]<Val>[/clr] cr.[br][br]Вы действительно хотите основать цитадель на этой планете?
  ButStabilizerOn	Включить стабилизатор
  ButStabilizerOff	Выключить стабилизатор
  ButWormhole	Открыть червоточину
  ErrorOpenWormhole	Чтобы открыть червоточину нужно соблюдение нескольких условий	[br]- В радиусе перехода от планеты с научной станцией должно быть свободное место.[br]- Червоточина открывается взамен существующей не стабилизированной червоточины.[br]- В созвездии не должно быть вражеских кораблей.[br]- Расстояние между выходами червоточины не должно быть менее 5 секторов. [br]- Стоимость открытия равна 200 000 ед. протоплазмы, которая должна находиться на одной из планет.
  ButPortalOn	Активировать портал
  ButPortalHyperOn	Активировать гипер-портал
  ButPortalOff	Деактивировать портал
  ButPortalJump	На другую сторону портала (пробел)
  ButPortalHyperJump	На другую сторону гипер-портала (пробел)
  ButPortalGo	Начать переход через портал (~)
  ButPortalCancel	Отменить переход через портал (~)
  PortalNoTech	Чтобы использовать портал у вас должен быть активирован инжектор науки или контроля.
  TechPortalNoPlusar	Переход возможен только при активном\nинжекторе науки или контроля.
  TechAntiExchangeNeed	Для изучения требуется 26 защитных технологий.
  StabilizerQuery	Стабилизатор предназначен для предотвращения закрытия червоточин в радиусе одного перелета. [br][br]Вы действительно хотите включить стабилизатор?
  ToCotlMenu	Созвездие игрока
  PactMenu	Договор
  PactWar	Объявить о нападении
  PactCaption	Договор между <font color='#ffff00'><You></font> и <font color='#ffff00'><User></font>
  PactCaptionQuery	Игрок <font color='#ffff00'><User></font> предлагает заключить договор
  PactYouCaption	Вы обязуетесь
  PactOtherCaption	Противоположная сторона обязуется
  PactYouPass	Мирно пропускать корабли противоположной стороны на свою территорию.
  PactOtherPass	Мирно пропускать Ваши корабли на свою территорию.
  PactYouNoFly	Не летать на территорию противоположной стороны.
  PactOtherNoFly	Не летать на вашу территорию.
  PactYouNoBattle	Не вести бой с противоположной стороной вне своих территорий.
  PactOtherNoBattle	Не вести бой с Вами вне своих территорий.
  PactYouPay	Платить противоположной стороне от добычи
  PactOtherPay	Платить вам от добычи
  PactYouProtect	Защищать противоположную сторону и получать оплату за успешную оборону.
  PactOtherProtect	Защищать Вас и получать оплату за успешную оборону.
  PactYouControl	Разрешить противоположной стороне управлять вашими кораблями.
  PactOtherControl	Разрешить Вам управлять кораблями противоположной стороны.
  PactYouBuild	Разрешить противоположной стороне строить ваши корабли и инфраструктуру планет.
  PactOtherBuild	Разрешить Вам строить у противоположной стороны корабли и инфраструктуру планет.
  PactAntimatter	Антиматерии
  PactMetal	Металла
  PactElectronics	Электроники
  PactProtoplasm	Протоплазмы
  PactNodes	Нодов
  PactPeriod	Продолжительность
  PactHour	дней
  PactOffer	Предложить
  PactBreak	Расторгнуть
  PactReject	Отклонить
  PactAccept	Принять
  PactListBut	Договора
  PactListCaption	Список договоров
  PactListName	Игрок
  PactListUnion	Альянс
  PactListDate	До окончания
  PactListRes	Ресурсы
  Cpt	Капитан
  CptAll	Ваши капитаны
  CptNew	Новый капитан
  CptReplace	Заменить капитана
  CptDelete	Уволить капитана
  CptTalent	Технологии флагмана
  CptEq	Оборудование флагмана
  CptDeleteQuery	'Чтобы уволить капитана "<Name>" введите слово "DELETE"	',  
  CptDeleteWarning	[justify][crt]ВНИМАНИЕ ![/crt] При увольнении будет потерян весь опыт, потраченный на изучение технологий капитана. Если вы хотите сохранить опыт, вам нужно сначала взять перераспределение технологий, затем разучить технологии увольняемого капитана и только затем уволить капитана.[/justify]
  CptDeleteBut	УВОЛИТЬ
  CptNoMore	Вы не можете иметь больше 4 капитанов.
  CptNoChangeExistFlagship	Вы не можете поменять капитана, так как у данного есть флагман.
  FormDialogMaxQuest	У вас на выполнение придельное количество квестов. Вы не можете взять больше.
  FormBattleSearchBut	В бой!
  FormBattleBar1	1x1
  FormBattleBar2	2x2
  FormBattleBarFlagship	С флагманами
  FormBattleSearch	Поиск <Val>...
  FormBattleCombat	Битва <Val>...
  FormBattleDuel	Поединок ...
  FormBattleSearchNoFlagship	[crt]ВНИМАНИЕ ![/crt] При битве с флагманами во флоте должны находиться флагманы.
  FormBattleSearchNoMass	[crt]ВНИМАНИЕ ![/crt] Для битвы вы должны иметь во флоте не менее [clr]300 000[/clr] кт массы кораблей.
  FormBattleWaitCnt	Игроков в очереди
  FormBattleWaitNeedCnt	[crt]Не хватает игроков.[/crt]
  FormBattleWaitEnd	До начала поиска
  FormPlusarButReplenish	ПОПОЛНИТЬ
  FormPlusarCaption	ИНЖЕКТОР
  FormPlusarModulePage	производства
  FormPlusarModuleCaption	Инжектор производства
  FormPlusarModuleText	[justify][p]Во время действия данного инжектора объем производства товаров финального цикла (деньги - cr, модули, топливо, оборудование, инженеры, пилоты и т.д.) увеличивается на 50%.[/p][/justify][br]Продолжительность	 [clr]7[/clr] дней" 
  FormPlusarModuleQuery	Вы действительно хотите активировать инжектор производства?
  FormPlusarModuleQuery2	Вы действительно хотите продлить инжектор производства?
  FormPlusarCaptainPage	капитанов
  FormPlusarCaptainCaption	Инжектор капитанов
  FormPlusarCaptainText	[justify][p]При активации данного инжектора Вы можете иметь сразу 3 флагмана. Дополнительно Вы получаете удвоенный приход очков опыта.[/p][/justify][br]Продолжительность	 [clr]7[/clr] дней" 
  FormPlusarCaptainQuery	Вы действительно хотите активировать инжектор капитанов?
  FormPlusarCaptainQuery2	Вы действительно хотите продлить инжектор капитанов?
  FormPlusarTechPage	науки
  FormPlusarTechCaption	Инжектор науки
  FormPlusarTechText	[justify][p]При активации инжектор позволяет изучать технологии дальше 4 уровня, ускоряет ход исследований в 3 раза, увеличивает продолжительность работы глобального планетарного щита на 2 часа, дает возможность ставить в очередь изучение вторую технологию, а также разрешает кораблям проходить через портал.[/p][/justify][br]Продолжительность	 [clr]7[/clr] дней
  FormPlusarTechQuery	Вы действительно хотите активировать инжектор науки?
  FormPlusarTechQuery2	Вы действительно хотите продлить инжектор науки?
  FormPlusarControlPage	контроля
  FormPlusarControlCaption	Инжектор контроля
  FormPlusarControlText	[justify][p]Комплексный инжектор, в который входят инжекторы производства, капитанов и науки. Инжектор, за одинаковый промежуток времени, стоит дешевле на [clr]<Val>%[/clr] чем его составляющие вместе взятые.[/p][p]При продлении любого инжектора (до истечения срока его работы), применяется накопительная скидка.[/p][/justify][br]Продолжительность	 [clr]30[/clr] дней" 
  FormPlusarControlQuery	Вы действительно хотите активировать инжектор контроля?
  FormPlusarControlQuery2	Вы действительно хотите продлить инжектор контроля?
  FormPlusarCost	Стоимость активации	 [clr]<Val>[/clr] egm
  FormPlusarCost2	Стоимость продления	 [clr]<Val>[/clr] egm с учетом скидки в [clr]<Discount>%[/clr].
  FormPlusarEGM	На вашем счету [clr]<Val>[/clr] egm.
  FormPlusarButOn	АКТИВИРОВАТЬ
  FormPlusarButProlong	ПРОДЛИТЬ
  FormPulsarPlusarOn	[crt]Инжектор активирован.[/crt] До завершения
  NoEnoughEGM	На вашем счете не хватает egm для активации инжектора.
  NoEnoughEGM2	На вашем счете не хватает egm.
  NoEnoughMoney	Не хватает денег (cr).
  NoEnoughRes	Не хватает товара.
  NoEnoughModule	Не хватает модулей.
  ErrOverload	Операция отклонена в связи с переполнением ангаров!
  ErrData	Ошибка в данных
  AIGameSet	Поведение компьютерной империи
  AIGameSetTransportNet	Автоматическая транспортная сеть
  AIGameSetTransport	Транспорты для перевозки грузов
  AIGameSetDefence	Постройка обороны
  ErrNoHomeworld	Торговля не возможна, так как нет столицы.
  ButPlanetShield	Активировать планетарный щит
  ButPlanetShieldOff	Деактивировать планетарный щит
  PlusarPlanetShield	<p align='justify'>Активированный планетарный щит поглощает энергию кораблей, тем самым замедляя скорость боя и захват планет. В первый час активации щит работает на полной мощности. При этом он замедляет бой в 100 раз. Каждый следующий час эффективность щита падает, что ведет к увеличению скорости боя на 2%. После 48 часов щит автоматически отключается. Щит никак не влияет, если бой идет не между игроками. Если на орбите планеты идет битва, то щит потребляет при полной нагрузке 15000 модулей в час. </p>\nСтоимость	 <font color='#ffff00'>200</font> egm.\n\nВы действительно хотите активировать планетарный щит?
  PlusarPlanetShieldOff	На деактивацию планетарного щита уходит 30 минут.\nВы действительно хотите деактивировать планетарный щит?
  ShildPower	Планетарный щит
  DeactivateShieldTime	Деактивация через
  DeactivateShieldTimeFull	Деактивация планетарного щита
  GlobalShieldFrom	Планетарный щит через
  GloablShieldCooldown	Восстановление щита
  LocalShieldVal	Планетарный щит анклава
  LocalShieldAtk	Угроза
  LocalShieldEnd	Деактивация через
  FormTechCaption	Технологии империи
  NextLvl	Следующий уровень
  TechCostLvl	Стоимость
  TechNoRes	У вас не хватает ресурсов для изучения выбранной технологии.
  TechResearch	Изучается
  TechProgress	\n Исследовано <font color='#ffff00'><Val></font> из <font color='#ffff00'><Max></font>. Скорость <font color='#ffff00'><Speed></font> ед. в час.\n До завершения осталось <font color='#ffff00'><Time></font> минут.
  TechResearchNext	Следующая
  TechResearchNoMore	Чтобы получить доступ к возможности задавать две технологии для изучения, вам надо активировать инжектор науки или контроля.
  TechNeedPrev	Чтобы изучить данную технологию вы должны сначала изучить 2 технологии в вышестоящем ряду.
  TechNeedCadet	Технологии 3 уровня можно изучить, только если вы достигли звания кадет.
  TechNeedPlusar	Технологии начиная с 4 уровня можно изучить, только если активирован инжектор науки или контроля.
  TechUnResearchQuery	Вы уверены, что хотите уничтожить технологию?
  TechShowFullList	Ctrl - посмотреть все неизученные уровни технологии.
  TechGravWell	[clr]Гравитационный колодец[/clr] - не позволяет покинуть планету любому звену кораблей в течении [clr]5[/clr] минут. Закрывает все порталы и блокирует их открытие.
  TechBlackHole	[clr]Черная дыра[/clr] - мгновенно поглощает звено кораблей. Не действует на разрушители.
  InfoAntiGravitor	Гравитационный стабилизатор
  InfoGravWell	Гравитационный колодец
  InfoBlackHole	Черная дыра
  CooldownAntiGravitor	До гравитационного стабилизатора
  CooldownGravWell	До гравитационного колодца
  CooldownBlackHole	До черной дыры
  GravWellOff	До окончания гравитационного колодца
  PotentialOff	До окончания гравитационного потенциала
  ReloadReactor	Перезагрузка реактора
  TalentCaption	Технологии флагмана
  TalentCpt	Капитан
  InvuOff	До деактивации протонного щита
  InvuOn	До готовности протонного щита
  RechargeOn	До восстановления зарядника
  ConstructorOn	До восстановления конструктора
  GravitorOff	До деактивации гравитора
  GravitorPrepare	До активации научного гравитора
  GravitorOn	До готовности гравитора
  GravitorAccess	До гравитора
  AcceleratorOn	До ускорения
  CoverOn	До прикрытия
  ExchangeOn	До готовности квантового перехода
  BarrierOn	До возможности освободить барьер
  PortalOn	До готовности активации портала
  PortalCnt	Осталось кораблей до деактивации портала
  PortalInfo	Портал
  PortalInfoFlagship	Флагманский портал
  PortalInfoHyperspace	Гипер-портал
  PortalInfoHyperspaceCotlOther	в созвездие <Name>
  PortalInfoHyperspaceCotlUser	в созвездие игрока <Name>"  
  SupplyByPact	По договорам
  OutControl	Вне контроля
  Occupy	Оккупирована
  SDMMax	Макс. очки развития
  SDM	Остаток очков развития
  BuildSDM	Строить корабли за sdm
  MulTime	Мультипликатор
  CurrencyModule	модули
  CurrencySDM	sdm
  FormSetCaption	НАСТРОЙКИ
  SetBut	Настройки
  HourPlanetShield	Час активации планетарных щитов"  
  FormSetHourPlanetShield	- час активации планетарных щитов.
  FormSetAccessKey	- код доступа.
  FormSetHint	подсказки.
  FormSetFPS	отображение FPS.
  FormSetFPSMax	- максимальный FPS
  FormSetScopeVis	границы видимости.
  FormSetUnprintable	Фильтр нецензурной лексики
  FormSetTabGame	игра
  FormSetTabGraph	графика
  FormSetFon	отображение фона.
  FormSetShieldPercent	отдельное отображение числовых процентов щита.
  FormSetButSave	СОХРАНИТЬ
  FormSetButFon	ФОН
  FormSetButFlashSettings	FLASH
  FormSetButFlashSettings2	FLASH 2"  
  PortalCaption	Портал
  PortalSector	Сектор
  PortalSet	Установить
  AdviserBut	Советник
  EmpireDestroyTime	Осталось до распада империи
  RestartTime	Осталось до рестарта созвездия
  PrepareTime	Осталось до готовности созвездия
  GalaxyMapClanIcon	Иконки альянсов
  GalaxyMapCurBattle	Текущие битвы
  CotlDef	В защите
  CotlAtk	В атаке
  CotlCaptureAndControl	Захватить и установить контроль" 
  CotlCapture	Захватить созвездие
  CotlCaptureQuery	Вы уверены, что хотите захватить созвездие?
  CotlCaptureNextHour	Час открытия
  CotlBuyControl	Установить контроль" 
  CotlBuyControlQuery	Вы уверены, что хотите установить контроль над созвездием за [clr]<Price> <Val>[/clr]?" 
  CotlBuyControlQueryPlusEgm	Вы уверены, что хотите установить контроль над созвездием за [clr]<Price> <Val>[/clr] и [clr]<PriceEGM> egm[/clr]?" 
  CotlPrice	За [clr]<Price> <Val>[/clr] возможно установить контроль над созвездием." 
  CotlPriceEgm	За [clr]<Price> <Val>[/clr] и [clr]<PriceEGM> egm[/clr] возможно установить контроль над созвездием." 
  CotlSessionContinue	От старта
  CotlSessionEnd	До завершения
  CotlSessionBegin	До старта
  SessionEnd	До окончания игры
  SessionBegin	До начала игры
  RaceChangeCooldown	Вы можете сменить расу через: <Val>
  NewBaseCooldown	Вы можете создать базу в этом созвездии через: <Val>
  NewCitadelCooldown	Вы можете основать цитадель в этом созвездии через: <Val>
  NewCitadelMax	Нельзя иметь больше 5 цитаделей.
  NewEmpireCooldown	Вы можете создать новую империю через: <Val>"  
  FormNewCptCaption	НОВЫЙ КАПИТАН
  FormNewCptReplaceCaption	ЗАМЕНА КАПИТАНА
  FormNewCptDeleteCaption	УВОЛИТЬ КАПИТАНА
  FormNewCptName	Имя"  
  FormNewCptRace	Раса
  FormNewCptButReplace	ЗАМЕНИТЬ
  FormNewCptButOk	НАНЯТЬ
  FormNewCptButCancel	ОТКАЗАТЬСЯ
  CptMaxLvl	Вы уже достигли максимального [clr]<Val>[/clr] уровня технологий капитана.
  CptNoExpForTech	Вам не хватает [clr]<Val>[/clr] очков опыта, чтобы изучить технологию.
  CptLvl	Уровень
  Exp	Опыт
  ShipExp	Если вы уничтожите эти корабли, то заработаете [clr]<Exp>[/clr] очков опыта.
  FlagshipExp	Если вы уничтожите этот флагман, то заработаете <font color='#BfBf00'><Exp></font> очков опыта." 
  MobExp	Если вы уничтожите эти корабли, то заработаете <font color='#BfBf00'><Exp></font> очков опыта.
  UnknowExp	Невозможно рассчитать получаемый вами опыт при уничтожении этих кораблей.
  CostExp	Стоимость изучения новой технологии <font color='#ffff00'><Cost></font> очков опыта.\nУ вас имеется <font color='#ffff00'><Exp></font> очков опыта.
  FleetUser	Флот игрока
  CotlRich	Центральное созвездие
  CotlUser	Созвездие игрока
  CotlOccupancy	Занятость созвездия
  CotlProtect	Под защитой
  CotlProtectTime	До окончания защиты
  CotlProtectPermanent	Под постоянной защитой
  FlagshipPowerDec	Мощность флагманов
  FlagshipPowerDecShort	Мощность
  SoundChannel	Радио канал" 
  SoundVol	Громкость" 
  SoundOn	Включить радио канал" 
  SoundOff	Выключить радио канал" 
  SoundLoadPls	Загрузить список каналов..." 
  ItemBonusEndTime	До завершения
  FindUser	Найти
  FindCotlKeyword	созвездие
  FindImportKeyword	импорт
  FindExportKeyword	экспорт
  FleetCaption	Флот
  FleetDesc	Флот под командованием капитана предназначен\nдля операций в других созвездиях.
  FleetCpt	Корабли входят во флот капитана
  FleetOut	Корабли вне флота
  FleetNew	Флагман образует ядро флота
  FleetArrival	Время до прибытия
  FleetGroupCnt	Звеньев
  FleetIn	Во флоте капитана
  FleetMoveError	Перелет флота запрещен согласно параграфу #<Val>.
  FleetMoveErrorNoReady	Корабли флота не готовы к гиперпереходу.
  FleetMoveErrorBattle	Корабли флота не могут покинуть орбиту боя.
  FleetMoveErrorNoShip	Нет кораблей во флоте.
  FleetMoveErrorNoFlagship	Нет флагмана во флоте.
  FleetMoveErrorMuch	На орбите планеты слишком много ваших кораблей.
  FormRaceCaption	Раса империи
  FormRaceCaption2	Выберите расу для новой империи	
  FormRaceCaption2Pay	Выберете расу для империи	
  FormRaceWarningDestroy	[crt]ВНИМАНИЕ![/crt] У вас уже есть империя. При основании новой столицы старая империя будет уничтожена.
  FormRaceWarningPay	[crt]ВНИМАНИЕ![/crt] Стоимость смены расы без уничтожения империи равна [clr]<Val>[/clr] egm.
  FormRaceButOk	Основать
  FormRaceButOkPay	Сменить
  FormRaceWarningWait	Раса сменится через несколько секунд.
  FormRaceShip	Корабли
  FormRaseFeatures	Особенности
  FormRaseFeaturesGrantar	- Структура кораблей на 60% больше.[br]- Девастаторы аннигилируют быстрее и наносят вражеским кораблям дополнительно 100% урона.[br]
  FormRaseFeaturesPeleng	- Скорость кораблей на 50% больше, что позволяет покинуть бой, при этом не теряя скорость при уходе с орбиты вражеской планеты.[br]- На передовой ударная сила кораблей увеличивается на 50%.[br]- Крейсеры на передовой с вероятностью 20% взламывают 4 крейсера противника.[br]
  FormRaseFeaturesPeople	- В бою корабли используют нанитов, которые разбирают структуру вражеских кораблей для ремонта своих собственных. Что увеличивает урон на 30% и ремонтирует собственные корабли со скорость 25% от повреждений вражеских кораблей.[br]
  FormRaseFeaturesTechnol	- Корабли, при потере 50% структуры, оснащены энергетическим щитом, который блокирует 95% повреждений с 30% коэффициентом рассеивания.[br]- Дредноуты могут менять режим лазера с боевого на трансиверный. Что позволяет восстанавливать щиты у кораблей.[br]
  FormRaseFeaturesGaal	- Корабли оснащены барьером, который уменьшает урон на 25%, при этом накапливает энергию, позволяющую мгновенно нанести большой урон вражеским кораблям.[br]
  FormRadarGalaxyMap	Галактическая карта
  FormRadarRadar	Радар" 
  UnionCaption	Альянс
  UnionNewCaption	Создание нового альянса
  UnionNewDesc	Стоимость создания нового альянса\nсоставляет <font color='#ffff00'><Val></font> egm.
  UnionNewCreate	Создать
  UnionNewType	Тип
  UnionNewCptName	Русское имя
  UnionNewCptNameEng	Имя латиницей
  FormUnionPageMember	Состав
  FormUnionPageInfo	Информация
  FormUnionPageNames	Названия
  FormUnionPageBonus	Бонус" 
  FormUnionName	Название альянса
  FormUnionNameLang	Русское название альянса
  FormUnionNameEng	Название альянса латиницей
  FormUnionDesc	Краткое описание (по-русски)
  FormUnionDescEng	Краткое описание (по-английски)
  FormUnionSite	Сайт
  FormUnionAdmin	Лидер
  FormUnionEmblemSmall	Малая эмблема
  FormUnionEmblemLarge	Большая эмблема
  FormUnionHello	Объявление
  FormUnionInfo	Текст
  FormUnionRenameCost	Стоимость переименования альянса\nсоставляет <font color='#ffff00'><Val></font> egm.
  FormUnionUser	Игрок
  FormUnionRank	Звание
  FormUnionJoin	Пригласить в альянс
  FormUnionCancelQuery	Вы хотите отозвать заявку на присоединение к альянсу?
  FormUnionJoinQuery	Вы хотите войти в альянс?
  FormUnionAccessTitle	Права	
  FormUnionAccessHeader	Изменение шапки
  FormUnionAccessInfo	Изменение информации
  FormUnionAccessInvite	Приглашние в альянс
  FormUnionAccessExclusion	Исключение из альянса
  FormUnionAccessRank	Изменение звания
  FormUnionAccessAccess	Изменение прав
  FormUnionAccessChatEdit	Администрирование чата
  FormUnionLeave	Покинуть
  FormUnionLeaveNoAdmin	Лидер может покинуть альянс, только если он один в альянсе.
  FormUnionLeaveQuery	Вы действительно хотите покинуть альянс?
  FormUnionExclusion	Исключить из альянса
  FormUnionChangeAdmin	Передать право лидера
  FormUnionChangeAdminQuery	Вы уверены, что хотите передать право лидера?
  FormUnionNameUnion	Альянс
  FormUnionNameRank	Звание
  FormUnionNameAdmin	Лидер
  FormUnionNameRank0	Звание 1
  FormUnionNameRank1	Звание 2
  FormUnionNameRank2	Звание 3
  FormUnionNameRank3	Звание 4
  FormUnionNameRank4	Звание 5
  FormUnionNameCapLang	По-русски
  FormUnionNameCapEng	По-английски
  FormUnionCotlCnt	Вы захватили [clr]<Val>[/clr] созвездий.[br]Что составляет [clr]<Proc>%[/clr] от галактики.
  UnionErrExistName	Ошибка. Альянс с таким именем уже существует.
  UnionErrExistNameEng	Ошибка. Альянс с таким латинским именем уже существует.
  FormUnionErrImgFormat	Ошибка. Изображение должно быть в формате png.
  FormUnionErrImgSmallSize	Ошибка. Избражение должно быть 24 на 24 пикселя и не привышать 4 кб.
  FormUnionErrImgLargeSize	Ошибка. Избражение должно быть 100 на 100 пикселей и не привышать 16 кб.
  FormUnionErrDescLine	Ошибка. В описании не должно быть больше 2 строк.
  FormUnionErrHelloLine	Ошибка. В объявлении не должно быть больше 6 строк.
  FormUnionErrInfoLine	Ошибка. В объявлении не должно быть больше 50 строк.
  FormUnionErrText	Ошибка в данных введенными вами.
  FormUnionErrAlreadyJoin	Пользователь уже состоит в альянсе
  FormUnionErrAccess	Ошибка	 Нет доступа.
  FormTalentButRelocate	Перераспределить
  FormTalentQueryRelocate	За [clr]15 000[/clr] egm вы можете войти в [clr]60[/clr] минутный режим перераспределения всех технологий у всех капитанов.\nВы хотите активировать этот режим?
  FormTalentTimeRelocate	До завершения режима перераспределения\nосталось <font color='#ffff00'><Val></font> минут.
  FormTalentNoUnresech	Разучить технологию вы можете только в режиме перераспределения.
  FormEnterCaption	ВХОД
  FormEnterName	E-mail
  FormEnterPassword	Пароль
  FormEnterBut	ВОЙТИ
  FormEnterButTraining	ОБУЧЕНИЕ
  FormEnterSaveName	Запомнить имя
  FormEnterSaveAll	Запомнить ключ доступа
  FormEnterHWOff	Чтобы продолжить вы должны войти в настройки и включить аппаратное ускорение. Затем перезайти в игру.
  FormEnterHWOffAIR	Чтобы продолжить вы должны войти в игру через сайт и включить аппаратное ускорение графики. После чего вы можете играть как в браузере так и в клиентской версии игры.
  FormEnterHWOldDriver	Чтобы продолжить вы должны установить новую версию драйвера к вашей видеокарте.
  FormEnterFlashOps	НАСТРОЙКИ
  FormEnterButExit	ВЫХОД
  FormEnterServer	Сервер
  FormEnterProtocol	Протокол
  FormEnterScale	Масштаб
  FormEnterTxtTraining	[justify]Начав обучение, вы в интерактивном режиме познакомитесь со многими аспектами достаточно сложной, но интересной игры. По завершению обучения вам предложат создать новый аккаунт, после чего вы сможете совместно играть с другими игроками.[/justify]
  FormEnterTabTraining	обучение
  FormEnterTabLogin	логин
  FormEnterTabSet	настройки
  FormEnterProtocolRaw	Raw
  FormEnterProtocolDefaultHTTP	Default HTTP
  FormEnterNewNameCaption	ИМЯ
  FormEnterNewNameCaptionNewName	НОВОЕ ИМЯ
  FormEnterNewNameTxtNewName	Ваш псевдоним купил другой игрок. Введите ваш новый псевдоним	
  FormEnterNewNameTxt	Введите ваш публичный псевдоним, чтобы отличать вас от других игроков	
  FormEnterNewNameErrName	Ошибочное имя.
  FormEnterNewNameErrLen	Имя должно содержать от 2 до 16 символов.
  FormEnterNewNameErrChar	Имя должно состоять только из букв одного алфавита, цифр или пробела.
  FormEnterNewNameErrBadWord	В имени не должна содержаться ненормативная лексика.
  FormEnterNewNameErrReserve	Имя зарезервировано.
  FormEnterNewNameErrNone	Имя свободно.
  FormEnterNewNameErrUse	Имя занято. Выберите другое.
  FormEnterContinue	ПРОДОЛЖИТЬ
  FormBuyNameMenu	Покупка имени
  FormBuyNameCaption	ПОКУПКА ИМЕНИ
  FormBuyNameTxt	[justify][p]За <Price> egm вы можете купить новый псевдоним. Купить можно только тот псевдоним, который не куплен другим игроком. Если другой игрок использует псевдоним купленный вами, то ему придется сменить свой псевдоним на новый.[/p][p]Кроме того, при покупке имени, вам дается либо продлевается инжектор контроля на 15 дней.[/p][/justify]
  FormBuyNameButBuy	КУПИТЬ
  FormBuyNameComplate	Псевдоним успешно приобретен. Изменения вступят через несколько секунд.
  FormRegCloneMenu	Регистрация клона
  FormRegCloneCaption	РЕГИСТРАЦИЯ КЛОНА
  FormRegCloneTxt	[justify][p]Если у вас имеется больше одного аккаунта, то вы должны зарегистрировать дополнительные аккаунты как клоны. Для этого введите в нижеследующие поля e-mail и пароль основного аккаунта. И после регистрации данный аккаунт будет привязан к основному как клон.[/p][p]Допускается одновременно играть только на одном аккаунте, но при этом другие аккаунты будут заблокированы на две недели. По истечению этого времени вы можете переключиться на любой другой клон-аккаунт. Блокировка и переключение происходит автоматически при входе в игру.[/p] [p][crt]ВНИМАНИЕ ![/crt] Запрещено иметь не зарегистрированных клонов званием “кадет” и выше. Не соблюдение этого закона влечёт за собой блокирование доступа к игре и большому штрафу![/p] [/justify]
  FormRegCloneBut	РЕГИСТРАЦИЯ
  FormRegCloneErrNoAccess	[crt]ОШИБКА[/crt]. Скорей всего вы не правильно указали e-mail и пароль основного аккаунта.
  FormRegCloneErrNeedOther	[crt]ОШИБКА[/crt]. Требуется указать основной аккаунт или другой клон-аккаунт.
  FormRegCloneComplate	Клон успешно зарегистрирован.
  FormRegMenu	Регистрация
  FormRegEmailCaption	РЕГИСТРАЦИЯ
  FormRegEmailText	[justify][p]Пройдя процедуру регистрации, введя email и пароль для входа в игру, вы конвертируете данный временный аккаунт в постоянный и привяжете его к свой почтовому ящику.[/p][p]Пожалуйста, укажите правильный email, для того чтобы в случае утраты пароля вы смогли восстановить доступ к аккаунту.[/p][p][crt]ВНИМАНИЕ![/crt] Запрещено использовать не зарегистрированных клонов. Не честных игроков выявляем, затем штрафуем и банем.[/p][/justify][br]
  FormRegEmailComplate	[justify]Регистрация завершена.[/justify]
  FormRegEmail	Email
  FormRegPassword	Пароль
  FormRegReg	РЕГИСТРАЦИЯ
  FormRegErrUse	На данный email уже зарегистрирован аккаунт. Укажите другой.
  FormRegErrChar	Не корректный email.
  FormRegErrPwdLen	Не указан пароль.
  FormNewsCaption	Галактические новости
  FormNewsLinkImport	Импорт
  FormNewsLinkExport	Экспорт
  HyperspaceStar	Звезда
  HyperspacePlanet	Планета
  HyperspaceSputnik	Спутник
  HyperspaceInCotl	в созвездии
  HyperspaceInCotlUser	в созвездии игрока
  HyperspaceAddCotlProtect	Добавить защитное созвездие
  HyperspaceCotlEditCaption	Параметры созвездия" 
  HyperspaceCotlId	Идентификатор" 
  HyperspaceCotlType	Тип
  HyperspaceCotlPfx	Префикс
  HyperspaceCotlName	Название
  HyperspaceCotlDesc	Описание
  HyperspaceCotlSize	Размер
  HyperspaceCotlProtectDate	Защита до
  HyperspaceCotlDevTime	До окончания разработки
  HyperspaceCotlDevDays	Дней
  HyperspaceCotlBonus	Бонус" 
  HyperspaceCotlBonusVal	Значение" 
  HyperspaceCotlRewardExp	Опыт" 
  HyperspaceCotlMaxRating	Максимальный рейтинг" 
  HyperspaceCotlDevNeed	Свободно для разработки.
  HyperspaceCotlDevelopment	В разработке
  HyperspaceCotlTemplate	Шаблон
  HyperspaceCotlPortalEnterShip	Вход кораблей
  HyperspaceCotlPortalEnterFlagship	Вход флагманов
  HyperspaceCotlPortalEnterAllItem	Все товары
  HyperspaceCotlCombat	Битва
  HyperspaceCotlDev	Разработчик
  HyperspaceCotlAccessAssignRights	Назначение прав
  HyperspaceCotlAccessView	Просмотр
  HyperspaceCotlAccessEditMap	Изменение карты
  HyperspaceCotlAccessEditCode	Изменение кода
  HyperspaceCotlAccessEditOps	Изменение настроек
  HyperspaceCotlDevBuy	Купить разработку
  HyperspaceCotlDevBuyContinue	Продлить разработку
  HyperspaceCotlDevBuyQuery	Вы можете начать разрабатывать данное созвездие за <Cost> cr. Право на разработку выдается сроком на один день.
  HyperspaceCotlDevBuyContinueQuery	Вы можете продлить на один день право разрабатывать данное созвездие за <Cost> cr.
  HyperspacePlanetName	Планета
  HyperspaceRace	Раса
  HyperspaceZoneEdit	Редактировать зону
  HyperspaceZoneRating	Рейтинг
  HyperspaceZonePrice	Стоимость
  HyperspaceZoneDev0	Разработчик 1
  HyperspaceZoneDev1	Разработчик 2
  HyperspaceZoneDev2	Разработчик 3
  HyperspaceZoneDev3	Разработчик 4
  FormFleetBarAutoPilot	Автоматическая работа пилотов
  FormFleetBarAutoGive	Автоматическое снаряжение кораблей
  FormFleetBarDestroyShip	Взорвать
  FormFleetBarDestroyShipQuery	Вы действительно хотите взорвать корабли?
  FormFleetBarCaption	Флот
  FormFleetBarLoadFuel	Заправить топливом
  FormFleetBarLoadFuelTxt	Объем топлива, которым нужно заправить флот	
  FormFleetBarLoadFuelOk	Заправить
  FormFleetBarBuyFuel	Купить топливо
  FormFleetBarBuyFuelCaption	Покупка топлива" 
  FormFleetBarBuyFuelCost	Стоимость (egm)" 
  FormFleetBarBuyFuelCnt	Вы хотите купить <font color='#ffff00'><Cnt></font> ед. топлива за <font color='#ffff00'><Sum></font> egm?" 
  FormFleetBarBuyHoldLvl	Расширение трюма
  FormFleetBarBuyHoldLvlQuery	Вы хотите купить для трюма флота 8 дополнительных мест за [clr]<Val>[/clr] cr?
  FormFleetBarBuyHoldCargoLvl	Расширение транспортного трюма
  FormFleetBarBuyHoldCargoLvlQuery	Вы хотите расширить транспортный трюм до [clr]x<Mul>[/clr] за [clr]<Val>[/clr] cr?
  FormFleetBarReturn	Возврат
  FormFleetBarFleetType	Построение
  FormFleetBarCotlMove	Бесплатный перенос созвездия
  FormFleetBarCotlMovePay	Платный перенос созвездия
  FormFleetBarReturnQuery	Один раз в [clr]8[/clr] часов вы можете вернуть свой флот на орбиту вашего созвездия. Вы хотите вернуть флот?"  
  FormFleetBarReturnCooldown	Вернуть флот на орбиту вашего созвездия можно через [clr]<Val>[/clr]."  
  FormFleetItemUse	Использовать
  FormFleetItemDestroy	Уничтожить
  FormFleetItemDestroyQuery	Вы действительно хотите уничтожить товар в трюме флота?
  FormGiveCaption	Снарядить
  FormGiveOk	Снарядить
  FormGiveCnt	Количество
  FormGiveType	Оборудование
  FormCombatCaptionCombat	Битва
  FormCombatCaptionDuel	Поединок
  FormCombatCaptionBattle	Битва
  FormCombatCaptionFlagship	с флагманами
  FormCombatFeaturesCombat	Особености	 [clr]Модули - 50%, Опыт - 100%, Захват товара[/clr]
  FormCombatFeaturesDuel	Особености	 [clr]Модули - 90%, Опыт - 10%[/clr]
  FormCombatFeaturesBattle	Особености	 [clr]Модули - 50%, Опыт - 300%[/clr]
  FormCombatModeCombat	Флот
  FormCombatModeStat	Статистика
  FormCombatModeRes	Награда
  FormCombatView	Просмотр битвы
  FormCombatOffer	Вызвать на поединок
  FormCombatAtk	Нападение
  FormCombatDef	Защита
  FormCombatAtkCaption	Нападение
  FormCombatDefCaption	Защита
  FormCombatUser	Игроки
  FormCombatRating	Рейтинг
  FormCombatMass	Флот
  FormCombatLost	Потери
  FormCombatDestroy	Уничтожено
  FormCombatDamage	Урон
  FormCombatModule	Модули
  FormCombatExp	Опыт
  FormCombatReturn	(Возврат)
  FormCombatInvite	Пригласить в битву
  FormCombatLeave	Покинуть битву
  FormCombatLeaveAndJump	Покинуть и вернуться
  FormCombatReady	Готов к битве
  FormCombatReadyShow	Готово к битве
  FormCombatEnter	Войти в битву
  FormCombatReadyTime	Битва начнется через
  FormCombatTimeBegin	До начала
  FormCombatTimeEnd	До завершения
  FormCombatTimePlacing	Расстановка кораблей. До начала активных действий: <Val>.
  FormCombatMsgBegin	[center]До начала активных действий разместите[br]корабли на стартовых позициях.[/center][br][center]Цель	 [clr]Уничтожение флота неприятеля и[br]удержание ключевых планет.[/clr][/center]
  FormCombatWin	Победа!
  FormCombatLoss	Поражение!
  FormCombatWinUser	Победил
  FormCombatWinUsers	Победили
  FormCombatWinAtk	Победила нападающая сторона!
  FormCombatWinDef	Победила защищающаяся сторона!
  FormCombatItemWin	Товары в космосе
  FormCombatItemLoss	Потерянные товары
  FormCombatItemTake	Вы подобрали товары
  FormCombatTake	Подобрать
  FormCombatNewOwner	Новый владелец
  FormCombatJoinQuery	Вы согласны?
  FormCombatExclude	Исключить
  FormCombatUp	Вверх
  FormCombatDown	Вниз
  FormCombatErrInBattle	Операция отклонена. Игрок уже участвует в битве.
  FormCombatErrNoReady	Операция отклонена. Двигатели флота игрока должны быть отключены.
  FormHistModeDesc	Описание
  FormHistModeJournal	Журнал
  FormHistModeImport	Импорт
  FormHistModeExport	Экспорт
  FormHistModeFind	Поиск
  FormHistGoodsCotl	Созвездие
  FormHistGoodsType	Товар
  FormHistGoodsDist	сек.
  FormHistGoodsCntIndefinitely	неограниченно
  FormHistGoodsCntImport	Требуется
  FormHistGoodsCntExport	Продается
  FormHistGoodsCntImport2	Требуемый объем
  FormHistGoodsCntExport2	Продаваемый объем
  FormHistGoodsStorage	Объем	 Владелец
  FormHistGoodsStorage2	Хранимый объем
  FormHistGoodsMoney	cr	 Владелец
  FormHistGoodsMoney2	cr
  FormHistGoodsCnt	Объем
  FormHistGoodsName	Наименование
  FormHistGoodsStep	ед.
  FormHistGoodsPrice	Цена
  FormHistGoodsStorage	Хранимый объем
  FormHistTradeSum	Сумма
  FormHistTradePrice	Цена
  FormHistImportCaption	Импортировать
  FormHistExportCaption	Экспортировать
  FormHistAdd	Добавить
  FormHistEdit	Изменить
  FormHistBuy	Купить
  FormHistSell	Продать
  FormHistGoodsAdd	Добавить товар
  FormHistGoodsEdit	Изменить товар
  FormHistGoodsDelete	Удалить товар
  FormHistAddCaption	Добавить запись
  FormHistEditCaption	Изменить запись
  FormHistDeleteCaption	Удалить запись
  FormHistDeleteQuery	Вы действительно хотите удалить запись?
  FormHistDate	Приоритет
  FormHistType	Тип
  FormHistTypeText	Простой
  FormHistTypeExt	Расширенный
  FormHistTypeLog	Лог
  FormHistText	Текст
  FormHistPages	Запись
  FormHistEnter	Войти
  FormHistJournal	Журнал
  FormHistErrTextLen	Ошибка	 Текст должен быть от 1 до 15000 символов.
  FormHistErrText	Ошибка	 В тексте присутствует недопустимый символ <CharCode> в позиции <Offset>.
  FormHistErrTagUnknown	Неизвестный тэг в позиции <Offset>.
  FormHistErrStackEmpty	Для закрывающего тэга [<Tag>] в позиции <Offset> должен присутствовать открывающий тэг.
  FormHistErrStackRemove	Найден неправильный закрывающий тэг в позиции <Offset>. Требуется закрывающий тэг	 [/<Tag>].
  FormHistErrStackFill	Не хватает закрывающего тэга [/<Tag>] в позиции <Offset>.
  FormHistErrStackSmall	Слишком много вложенных тэгов в позиции <Offset>.
  FormHistErrURL	Неправильный адрес в позиции <Offset>.
  FormHistErrText	Недопустимые символы в позиции <Offset>.
  FormHistTradeItemNoMore	У вас уже есть данный товар в торговой секции. Измените его, а не добавляйте новый.
  FormHistBeacon	Радиомаяк
  FormHistBeaconQuery	Во включенном состоянии радиомаяка, ваше созвездие видно на больших расстояниях. Вы уверены, что хотите его включить?
  FormMenuTech	Технологии
  FormMenuPactList	Договора
  FormMenuUnion	Альянс
  FormMenuPlusar	Инжекторы
  FormMenuNormalScreen	В оконный режим
  FormMenuFullScreen	На полный экран
  FormMenuSet	Настройки
  FormMenuCotlJump	Перенос созвездия
  FormMenuCotlNew	Новое созвездие
  FormMenuExit	Выход
  FormItemBalansCaption	Баланс
  FormItemBalansCnt	В наличии
  FormItemBalansNeed	Потребление
  FormItemBalansProd	Производство
  FormItemBalansBalans	Баланс
  FormPlanetItemBalans	Баланс
  FormPlanetToFleet	В трюм флота (пробел)
  FormPlanetToFleetMoney	Собрать (пробел)
  FormPlanetSackToFleet	Грабить в трюм флота (пробел)
  FormPlanetSackToFleetMoney	Грабить (пробел)
  FormPlanetToTransport	Загрузить в транспорты
  FormPlanetBuilding	Планетарные постройки
  FormPlanetCellUpgrade	Улучшить
  FormPlanetCellUpgradeBut	[Улучшить (пробел)]
  FormPlanetCellCancel	Отменить (пробел)
  FormPlanetCellDestroy	Разрушить
  FormPlanetCellDestroyQuery	Вы действительно хотите разрушить постройку на планете?
  FormPlanetCellDestroyModuleQuery	Вы действительно хотите потратить <Val> модулей, чтобы разрушить постройку на планете?
  FormPlanetItemShowCnt	Отображение количества
  FormPlanetItemNoMove	Не перевозить
  FormPlanetItemToPortal	Перебрасывать через портал
  FormPlanetItemImport	Импортировать
  FormPlanetItemExport	Экспортировать
  FormPlanetItemExportInfo	При автоматическом экспорте товара, раз в минуту товар перевозится с планеты в хранилище созвездия.[br]При одном цикле перевозки - потребляется топливо, которое должно находиться на планете.
  FormPlanetItemImportInfo	При автоматическом импорте товара, раз в минуту товар перевозится на планету из хранилища созвездия.
  FormPlanetItemDestroy	Уничтожить
  FormPlanetItemDestroyQuery	Вы действительно хотите уничтожить?
  FormPlanetItemClear	Очистить
  FormPlanetItemBuildDefectFactor	Брак
  FormPlanetItemBuild	Производить
  FormPlanetItemBuildNav	Обучать
  FormPlanetItemBuildIncHomeworldModule	Столичное производство
  FormPlanetItemBuildIncBaseModule	Производство на базе
  FormPlanetItemBuildInc	Производство
  FormPlanetItemBuildDec	Потребление
  FormPlanetItemBuildChain	Цикл производства
  FormPlanetItemBuildBase	Производимые товары
  FormPlanetItemBuildSupply	Потребляемые товары
  FormPlanetItemBuildAdd	Дополнительное производство
  FormPlanetItemEditItem	Редактируемый товар
  FormPlanetItemDifficult	Сложность
  FormPlanetEnergy	Электроэнергия
  FormPlanetNoEnough	Недостаточно электроэнергии.
  FormPlanetNoEnoughDel	Операция недопустима, так как будет недостаточно электроэнергии.
  FormPlanetStorageSize	Объем
  FormPlanetCityNalog	Деньги от налогов
  FormPlanetCityNalog2	Налоги
  FormPlanetBuildErrNoCrystalOre	Построить невозможно, так как на планете нет кристаллических разломов.
  FormPlanetBuildErrNoTitanOre	Построить невозможно, так как на планете нет ильменитовых месторождений.
  FormPlanetBuildErrNoSiliconOre	Построить невозможно, так как на планете нет кварцитных месторождений.
  FormPlanetBuildingNeedLargePlanet	Построить можно только на обитаемых планетах.
  FormPlanetBuildingNeedSmallPlanet	Построить можно только на малых планетах.
  FormPlanetOreCrystalName	Кристаллический разлом
  FormPlanetOreTitanName	Ильменитовое месторождение
  FormPlanetOreSiliconName	Кварцитное месторождение
  FormPlanetOreCrystalDesc	Из разлома можно добывать антикристаллы, если построить кристаллический резак.
  FormPlanetOreTitanDesc	Из месторождения можно добывать титан, если построить титановый рудник.
  FormPlanetOreSiliconDesc	Из месторождения можно добывать кремний, если построить кремниевый рудник.
  FormPlanetBonusCaptionNavigator	Навыки
  FormPlanetBonusChangeErrorBuildNav	В процессе обучения невозможно поменять навык у пилотов.
  FormPlanetBonusChangeErrorCntNav	Невозможно поменять навык у обученных пилотов.
  FormConstructionSelect	Выбрать постройку...
  FormConstructionCaption	Планетарные постройки
  FormConstructionPageBase	Основные
  FormConstructionPageMining	Добывающие
  FormConstructionPageRefining	Перерабатывающие
  FormConstructionPageLive	Культурные
  FormConstructionPageProduction	Производственные
  FormConstructionPageEquipment	Технологические
  FormConstructionBuyLvlFirst	Открыть за [clr]<Val>[/clr] cr
  FormConstructionBuyLvlFirstQuery	Вы хотите открыть постройку за [clr]<Val>[/clr] cr?
  FormConstructionBuyLvlQuery	Вы хотите перейти на следующий технологический уровень за [clr]<Val>[/clr] cr?
  FormSplitItemCaption	Распределение
  FormSplitItemOk	Распределить
  FormHyperspaceAttackQuery	Атаковать флот?"  
  FormHyperspaceLeaveOrbitQuery	Вы уверены, что хотите покинуть орбиту созвездия?
  FormHyperspaceLeaveOrbitLeave	ПОКИНУТЬ
  FormHyperspaceLeaveOrbitStay	ОСТАТЬСЯ
  FormFleetTypeCaption	Построение флота
  FormFleetType0Caption	Разведывательное
  FormFleetType1Caption	Боевое
  FormFleetType2Caption	Походное
  FormFleetType3Caption	Грузовое
  FormFleetType4Caption	Транспортное
  FormFleetTypeActivate	Активировать
  FormFleetTypeOpen	Открыть за [clr]<Val>[/clr] cr
  FormFleetTypeOpenQuery	Вы уверены, что хотите открыть это построение флота за [clr]<Val>[/clr] cr?
  FormFleetTypeNoChangeEmptyTransportCargo	Невозможно изменить построение флота.[br]Сначала вы должны очистить транспортные слоты.
  FormFleetTypeNoChangeLimitTransportCargo	Невозможно изменить построение флота, так как трюмы будут переполнены.[br]Сначала необходимо ограничить число товаров в транспортных слотах.
  FormFleetTypeNoChangeLimitMass	Невозможно изменить построение флота, так как масса флота слишком большая.[br]Сначала необходимо вывести лишние корабли из флота.
  FormFleetTypeNoChangeLimitSlot	Невозможно изменить построение флота, так как занято седьмое место во флоте.
  FormFleetTypeNoHomeOrbit	Построение флота можно изменить, только если флот находится на орбите вашего личного созвездия или созвездия с вашим анклавом.
  FormFleetTypeNoCotlMove	В грузовом или транспортном построении нельзя перенести личное созвездие.
  FormFleetType0Txt	[center]Масса флота	 [clr]300 000[/clr][/center]" 
  FormFleetType1Txt	[center]Масса флота	 [clr]900 000[/clr][/center]
  FormFleetType2Txt	[center]Масса флота	 [clr]1 400 000[/clr][/center]
  FormFleetType3Txt	[center]Масса флота	 [clr]450 000[/clr][/center][center]Транспортный трюм	 [clr]x5[/clr][/center]
  FormFleetType4Txt	[center]Масса флота	 [clr]600 000[/clr][/center][center]Транспортный трюм	 [clr]x10[/clr][/center]
  StorageCaption	Созвездие
  StoragePageDesc	i
  StoragePageJournal	Журнал
  StoragePageStorage	Хранилище
  StoragePageImport	Импорт
  StoragePageExport	Экспорт
  StoragePageFind	Поиск
  StorageOp	Меню
  StorageChange	Изменить
  StorageDel	Удалить
  StorageGoodsChangeCaption	Изменить
  StorageImportCaption	Импортировать
  StorageExportCaption	Экспортировать
  StorageChangeEx	Изменить детально
  StorageGoods	Товар
  StorageCnt	Кол-во
  StorageLimitImport	Предел
  StorageLimitExport	Предел
  StoragePrice	Цена
  StorageMin	Минимально
  StorageMax	Максимально
  StorageNeedMoney	Для обеспечения импорта товаров, в хранилище, не хватает <Sum> cr.
  StorageEd	ед.
  StorageStep	за <Val> ед.
  StorageBuy	Купить
  StorageSell	Продать
  StorageSum	Сумма
  StorageSearch	Поиск
  StorageSearchImport	Импорт
  StorageSearchExport	Экспорт
  StorageSearchCotl	Созвездие
  StorageGoToCaption	Настройки
  StorageGoToPage	Запись
  StorageGoTo	Установить
  StorageFilter	Фильтр
  StorageEnter	Войти
  StorageErrAccess	Ошибка	 Нет доступа.
  StorageSack	Грабить
  StorageSackCaption	Грабить
  StorageSackCnt	Кол-во
  ItemPageCurrency	Валюта
  ItemPageOre	Элементы
  ItemPageRefine	Сырьё
  ItemPageSupply	Снабжение
  ItemPageMaterial	Материалы
  ItemPageOutfit	Снаряжение
  ItemPagePilot	Пилоты
  ItemPageOther	Другое
  TicketExAttack	Идет бой
  TicketExAttackEnd	Завершился бой
  TicketCaptureTake	Захват планеты
  TicketCaptureLost	Потеря планеты
  TicketExSack	Разграбление ресурсов
  TicketExSackNewOwner	Грабитель
  TicketAttack	Идет бой на вашей планете в секторе <SectorX>,<SectorY> с агрессором <User> (<UserUnion>) 
  TicketAttackEnd	Завершился бой в секторе <SectorX>,<SectorY> с агрессором <User> (<UserUnion>).
  TicketPactSend	Вы отправили договор игроку <User> (<UserUnion>)
  TicketPactQuery	Вы получили договор от игрока <User> (<UserUnion>)
  TicketPactAccept	Вы заключили договор с игроком <User> (<UserUnion>)
  TicketPactReject	Договор с игроком <User> (<UserUnion>) был отклонен.
  TicketPactComplate	Завершен договор между Вами и игроком <User> (<UserUnion>).
  TicketPactNoRes	Не хватает ресурсов для заключения договора между Вами и игроком <User> (<UserUnion>).
  TicketPactTimeOut	Игрок <User> (<UserUnion>) не ответил на предложенный Вами договор.
  TicketPactTimeOut2	Вы не ответили на договор предложенный игроком <User> (<UserUnion>).
  TicketPactChange	Договор с игроком <User> (<UserUnion>) не заключен, так как изменились условия.
  TicketPactBreak	Разорван договор между вами и игроком <User> (<UserUnion>)."  
  TicketUnionJoinFromQuery	Вы предложили игроку <User> войти в альянс <Union>.
  TicketUnionJoinFromAccept	Игрок <User> присоединился к альянсу <Union>.
  TicketUnionJoinFromCancel	Вы отозвали заявку на присоединения игрока <User> к альянсу <Union>.
  TicketUnionJoinFromCancel2	Игрок <User> отказался войти в альянс <Union>.
  TicketUnionJoinToQuery	Игрок <User> предложил вам войти в альянс <Union>.
  TicketUnionJoinToAccept	Вы вошли в альянс <Union>.
  TicketUnionJoinToCancel	Игрок <User> отозвал заявку на присоединение вас к альянсу <Union>.
  TicketUnionJoinToCancel2	Вы отказались войти в альянс <Union>.
  TicketCaptureCaptureUser	Вы захватили планету игрока <User> (<UserUnion>).
  TicketCaptureCapture	Вы захватили планету.
  TicketCaptureLostUser	Игрок <User> (<UserUnion>) захватил вашу планету.
  TicketCaptureLost	Вы потеряли планету.
  TicketCaptureAntimatter	Захвачено антиматерии
  TicketCaptureMetal	Захвачено металла
  TicketCaptureElectronics	Захвачено электроники
  TicketCaptureProtoplasm	Захвачено протоплазмы
  TicketCaptureNodes	Захвачено нодов
  TicketSack	Игрок <User> разграбил планету на <Val> модулей." 
  TicketDelete	Удалить запись
  TicketAnnihilation	Игрок <User> аннигилирует девастаторы." 
  TicketCombat_Duel_New_From_Query	Вы вызвали игрока <User> (<UserUnion>) на поединок.
  TicketCombat_Duel_New_From_NoAnswer	Игрок <User> (<UserUnion>) не ответил на ваш вызов и не примет участие в поединке.
  TicketCombat_Duel_New_From_Ok	Игрок <User> (<UserUnion>) принял ваш вызов и примет участие в поединке.
  TicketCombat_Duel_New_From_Cancel	Игрок <User> (<UserUnion>) отказался участвовать в поединке.
  TicketCombat_Duel_New_To_Query	Игрок <User> (<UserUnion>) вызывает вас на поединок.
  TicketCombat_Duel_New_To_NoAnswer	Вы не ответили игроку <User> (<UserUnion>) на предложенный им поединок.
  TicketCombat_Duel_New_To_Ok	Вы согласились на поединок с игроком <User> (<UserUnion>).
  TicketCombat_Duel_New_To_Cancel	Вы отказались от поединка с игроком <User> (<UserUnion>).
  TicketCombat_Duel_Join_From_Query	Вы попросили игрока <User> (<UserUnion>) принять участие в поединке на вашей стороне.
  TicketCombat_Duel_Join_From_NoAnswer	Игрок <User> (<UserUnion>) не ответил на вашу просьбу и не примет участие в поединке на вашей стороне.
  TicketCombat_Duel_Join_From_Ok	Игрок <User> (<UserUnion>) принял вашу просьбу и примет участие в поединке на вашей стороне.
  TicketCombat_Duel_New_From_Cancel	Игрок <User> (<UserUnion>) отказался участвовать в поединке на вашей стороне.
  TicketCombat_Duel_Join_To_Query	Игрок <User> (<UserUnion>) просит вас принять участие в поединке на его стороне.
  TicketCombat_Duel_Join_To_NoAnswer	Вы не ответили игроку <User> (<UserUnion>) на его просьбу участия в поединке на его стороне.
  TicketCombat_Duel_Join_To_Ok	Вы согласились принять участие в поединке на стороне игрока <User> (<UserUnion>).
  TicketCombat_Duel_Join_To_Cancel	Вы отказались принять участие в поединке на стороне игрока <User> (<UserUnion>).
  TicketCombat_Battle_New_From_Query	Вы вызвали игрока <User> (<UserUnion>) на битву.
  TicketCombat_Battle_New_From_NoAnswer	Игрок <User> (<UserUnion>) не ответил на ваш вызов и не примет участие в битве.
  TicketCombat_Battle_New_From_Ok	Игрок <User> (<UserUnion>) принял ваш вызов и примет участие в битве.
  TicketCombat_Battle_New_From_Cancel	Игрок <User> (<UserUnion>) отказался участвовать в битве.
  TicketCombat_Battle_New_To_Query	Игрок <User> (<UserUnion>) вызывает вас на битву.
  TicketCombat_Battle_New_To_NoAnswer	Вы не ответили игроку <User> (<UserUnion>) на предложенную им битву.
  TicketCombat_Battle_New_To_Ok	Вы согласились на битву с игроком <User> (<UserUnion>).
  TicketCombat_Battle_New_To_Cancel	Вы отказались от битвы с игроком <User> (<UserUnion>).
  TicketCombat_Battle_Join_From_Query	Вы попросили игрока <User> (<UserUnion>) принять участие в битве на вашей стороне.
  TicketCombat_Battle_Join_From_NoAnswer	Игрок <User> (<UserUnion>) не ответил на вашу просьбу и не примет участие в битве на вашей стороне.
  TicketCombat_Battle_Join_From_Ok	Игрок <User> (<UserUnion>) принял вашу просьбу и примет участие в битве на вашей стороне.
  TicketCombat_Battle_New_From_Cancel	Игрок <User> (<UserUnion>) отказался участвовать в битве на вашей стороне.
  TicketCombat_Battle_Join_To_Query	Игрок <User> (<UserUnion>) просит вас принять участие в битве на его стороне.
  TicketCombat_Battle_Join_To_NoAnswer	Вы не ответили игроку <User> (<UserUnion>) на его просьбу участия в битве на его стороне.
  TicketCombat_Battle_Join_To_Ok	Вы согласились принять участие в битве на стороне игрока <User> (<UserUnion>).
  TicketCombat_Battle_Join_To_Cancel	Вы отказались принять участие в битве на стороне игрока <User> (<UserUnion>).
  FormExitCaption	ВЫХОД
  FormExitFast	быстрый
  FormExitLong	долгий
  FormExitCotlJumpCaption	ПЕРЕНОС СОЗВЕЗДИЯ
  FormExitCotlJumpDefault	стандартный
  FormExitCotlJumpPay	платный
  FormExitNewCpation	НОВОЕ СОЗВЕЗДИЕ
  FormExitNewRnd	случайное
  FormExitNewClear	обучение"  
  FormExitLongHour	Часов (не менее 2)
  FormDeleteCotlKey	Ключевое слово
  FormExitFastBut	БЫСТРЫЙ ВЫХОД
  FormExitLongBut	ДОЛГИЙ ВЫХОД
  FormExitCotlMoveBut	ПЕРЕНОС СОЗВЕЗДИЯ
  FormExitCotlMovePayBut	ПЛАТНЫЙ ПЕРЕНОС СОЗВЕЗДИЯ
  FormExitDeleteCotlBut	УДАЛИТЬ СОЗВЕЗДИЕ
  FormExitNewGameBut	НАЧАТЬ ЗАНОВО
  FormExitFastText	'[justify]Нажав на кнопку "[clr]Быстрый выход[/clr]" вы в течении 60 секунд покинете игру, при этом ваше созвездие становится неактивным и на него никто не может напасть.[/justify][br][justify]Быстрый выход не работает если в вашем созвездии есть враг. Вам нужно либо очистить родной сектор от неприятеля перед выходом, либо начать долгий выход при этом защищая свою территорию до истечения времени.[/justify][br][justify]Если вы просто закроете игру, то по истечению 5 минут активируется быстрый выход.[/justify]'
  FormExitLongText	'[justify]Указав количество часов и нажав кнопку "[clr]Долгий выход[/clr]" вы установите время когда покинете игру. По истечению этого времени ваше созвездие станет неактивным и вы в течение 30 минут не сможете войти в игру.[/justify][br][justify]Если вы просто закроете игру и в вашем созвездии есть неприятель, то по истечению 15 минут активируется долгий выход.[/justify]',
  FormExitCotlMoveText	'[justify]Вы можете бесплатно перенести ваше созвездие в то место, где находится ваш флот. Если ваш рейтинг меньше [clr]50000[/clr] очков, то после переноса созвездия вы в течение [clr]23[/clr] часов не сможете повторно (бесплатно) перенести созвездие. Если ваш рейтинг больше [clr]50000[/clr] очков, то вы не сможете перенести (бесплатно) созвездие в течение [clr]14[/clr] дней.[/justify][br][justify]При переносе происходит быстрый выход. Если в вашем созвездии враг, то перенести созвездие нельзя.[/justify]
  FormExitCotlMovePayText	'[justify]Вы можете за [clr]10000[/clr] egm перенести ваше созвездие в то место, где находится ваш флот. После переноса созвездия вы в течение [clr]7[/clr] дней - не сможете повторно (платно) перенести созвездие.[/justify][br][justify]При переносе происходит быстрый выход. Если в вашем созвездии враг, то перенести созвездие нельзя.[/justify]
  FormExitCotlMoveCooldown	Перенос будет доступен через [clr]<Val>[/clr].
  FormExitDeleteCotlText	'[justify]Если вам не понравилось сгенерированное для вас созвездие, вы можете его удалить, при условии, что в нем нет неприятеля. При этом вы выходите из игры, а все корабли и планеты в вашем созвездии уничтожаются. После повторного входа в игру вам будет сгенерировано новое созвездие.[/justify][br][justify]Чтобы удалить созвездие введете ключевое слово "[clr]DELETE[/clr]"</font> а затем нажмете кнопку "[clr]Удалить созвездие[/clr]"[/justify]',
  FormExitNewGameText	'[justify]Если вы хотите начать с чистого листа, то введете ключевое слово "[clr]NEW GAME[/clr]" а затем нажмете кнопку "[clr]Начать заново[/clr]". При этом вы выходите из игры, а все ваши ресурсы, достижения и т.д. - будут удалены. (За исключением суммы egm на вашем счету.) После повторного входа в игру вы сможете начать с чистого листа.[/justify]',
  ExitNoAgain	Вы не можете повторно задать время выхода из игры.
  ExitDate	До выхода
  ExitBegin	Начат процесс выхода из игры.
  ExitTimeout	Вы не можете войти на сервер. Попробуйте зайти через: <Val>
  Ban	Заблокирован доступ в игру для этого аккаунта." 
  BanDate	Заблокирован доступ в игру для этого аккаунта.[br]Вход будет разрешен через: <Val>" 
  WarningNoAttackFleetInStealth	[center][crt]ВНИМАНИЕ![/crt] Вы не можете определить координаты флота,[br]а следовательно не можете напасть на него.
  WarningNoMoveFleetInCombat	[center][crt]ВНИМАНИЕ![/crt] Флот не может перемещаться, пока участвует в битве.
  WarningNoBuildFlagshipIsBuildShip	[center][crt]ВНИМАНИЕ![/crt] Нельзя начать строить флагман,[br]если на планете уже строятся корабли.[/center]
  WarningNoBuildNoHomeworld	[crt]ВНИМАНИЕ![/crt] Запрещено строить флот без столицы.
  WarningNoMoreBuild	[crt]ВНИМАНИЕ![/crt] На орбите планеты можно строить только одну эскадру.
  WarningNoBuild	[crt]ВНИМАНИЕ![/crt] На орбите данной планеты вы не можете построить корабли.
  WarningMaxGroup	[center][crt]ВНИМАНИЕ![/crt] На орбите планеты не может быть больше[br]6 звеньев дружественных или вражеских кораблей.[/center]
  WarningRear	[crt]ВНИМАНИЕ![/crt] Флот не может быть размещен в тылу врага.
  WarningNoFuel	[crt]ВНИМАНИЕ![/crt] Не хватает топлива.
  WarningNeedMoreFuelForFly	[crt]ВНИМАНИЕ![/crt] Требуется [clr]<Val>[/clr] ед. топлива.
  WarningNoLeaveBattle	[crt]ВНИМАНИЕ![/crt] Флот не может покинуть орбиту боя.
  WarningNoToPulsar	[crt]ВНИМАНИЕ![/crt] Вы не можете выйти на орбиту активного пульсара.
  WarningPactNoFly	[crt]ВНИМАНИЕ![/crt] Вы заключили договор, по которому не можете находиться на орбите этой планеты.
  WarningLargeRating	[center][crt]ВНИМАНИЕ![/crt] Вы не можете переместить корабли, так как[br]ваш рейтинг слишком высок для данного созвездия.[/center]" 
  WarningItemFar	[center][crt]ВНИМАНИЕ![/crt] Вы не можете переместить товар, так как ваш флот[br]не находится на орбите данного созвездия.[/center]
  WarningItemMoveHoldOverload	[center][crt]ВНИМАНИЕ![/crt] Вы не можете переместить товар,[br]так как будет переполнение трюмов.[/center]
  WarningItemMoveBattle	[center][crt]ВНИМАНИЕ![/crt] Вы не можете переместить товар,[br]так как на орбите планеты находятся вражеские корабли.[/center]
  WarningItemNoAccessOpByRank	[center][crt]ВНИМАНИЕ![/crt] Данная операция запрещена по конвенции о званиях.[/center]
  WarningFleetFar	[center][crt]ВНИМАНИЕ![/crt] Вы не можете переместить корабли, так как ваш флот[br]не находится на орбите данного созвездия.[/center]
  WarningFleetFarFuel	[center][crt]ВНИМАНИЕ![/crt] Вы не можете загрузить топливо, так как ваши корабли не[br]находятся на орбите созвездия империи или анклава.[/center]
  WarningFleetFarEx	[center][crt]ВНИМАНИЕ![/crt] Вы не можете совершить данную операцию, так как ваш флот[br]не находится на орбите данного созвездия.[/center]
  WarningFleetFromHyperspaceProtectZone	[center][crt]ВНИМАНИЕ![/crt] Для этого созвездия корабли могут выйти из гиперпространства[br]только в специальные зоны.[/center]" 
  WarningFleetFromHyperspaceEnemy	[center][crt]ВНИМАНИЕ![/crt] Если по близости враг, то корабли могут выходить из[br]гиперпространства только на дружественную планету.[/center]
  WarningFleetFromHyperspaceEnemyAll	[center][crt]ВНИМАНИЕ![/crt] В полностью занятое созвездие, корабли могут выйти[br]из гиперпространство только на необитаемые планеты.[/center]
  WarningFleetFromHyperspaceWormhole	[center][crt]ВНИМАНИЕ![/crt] Корабли не могут выходить из гиперпространства[br]на орбиту пульсара или обычной червоточины.[/center]
  WarningFleetFromHyperspaceWormholeOpen	[center][crt]ВНИМАНИЕ![/crt] Корабли не могут выходить из гиперпространства[br]на орбиту нестабилизированной червоточины.[/center]
  WarningFleetFromHyperspaceRank	[center][crt]ВНИМАНИЕ![/crt] Корабли не могут выходить из[br]гиперпространства в созвездие новичка.
  WarningFleetFromHyperspaceRank2	[center][crt]ВНИМАНИЕ![/crt] Корабли новичка не могут выходить[br]из гиперпространства в другие созвездия.
  WarningFleetToHyperspaceBattle	[center][crt]ВНИМАНИЕ![/crt] Во время боя корабли не могут[br]совершить переход в гиперпространство.[/center]
  WarningFleetToHyperspaceNoFuel	[center][crt]ВНИМАНИЕ![/crt] Корабли не могут перейти в гиперпространство,[br]так как у них должно быть не менее 2ед. топлива.[/center]
  WarningFleetToHyperspaceInCombat	[center][crt]ВНИМАНИЕ![/crt] Во время битвы запрещен ручной переход[br]кораблей в гиперпространство.[/center]
  WarningFleetFromHyperspaceNoFuel	[center][crt]ВНИМАНИЕ![/crt] Корабли не могут выйти из гиперпространства,[br]так как во флоте должно быть не менее 10ед. топлива.[/center]
  WarningFleetFromHyperspaceProtectNoFuel	[center][crt]ВНИМАНИЕ![/crt] Корабли не могут выйти из гиперпространства,[br]так как во флоте не хватает топлива.[/center]" 
  WarningFleetNoAccessShipFromHyperspace	[center][crt]ВНИМАНИЕ![/crt] В данное созвездие запрещено выходить[br]кораблям из гиперпространства.[/center]
  WarningFleetNoAccessTransportFromHyperspace	[center][crt]ВНИМАНИЕ![/crt] В данное созвездие запрещено выходить[br]транспортам из гиперпространства.[/center]
  WarningFleetNoAccessInvaderFromHyperspace	[center][crt]ВНИМАНИЕ![/crt] В данное созвездие запрещено выходить[br]штурмовикам из гиперпространства.[/center]
  WarningFleetNoAccessFlagshipFromHyperspace	[center][crt]ВНИМАНИЕ![/crt] В данное созвездие запрещено выходить[br]флагманам из гиперпространства.[/center]
  WarningFleetNoAccessShipToHyperspace	[center][crt]ВНИМАНИЕ![/crt] Из данного созвездия запрещено входить[br]кораблям в гиперпространство.[/center]
  WarningFleetNoAccessTransportToHyperspace	[center][crt]ВНИМАНИЕ![/crt] Из данного созвездия запрещено входить[br]транспортам в гиперпространство.[/center]
  WarningFleetNoAccessInvaderToHyperspace	[center][crt]ВНИМАНИЕ![/crt] Из данного созвездия запрещено входить[br]штурмовикам в гиперпространство.[/center]
  WarningFleetNoAccessFlagshipToHyperspace	[center][crt]ВНИМАНИЕ![/crt] Из данного созвездия запрещено входить[br]флагманам в гиперпространство.[/center]
  WarningFleetNoAccessItemMove	[center][crt]ВНИМАНИЕ![/crt] Для данного созвездия запрещено перемещать товар[br]между планетой и флотом.[/center]
  WarningInDevNoExtract	[center][crt]ВНИМАНИЕ![/crt] В режиме разработки, запрещено извлекать[br]из созвездия корабли и товары.[/center]
  WarningFleetAddShipOutMass	[center][crt]ВНИМАНИЕ![/crt] Корабли не могут перейти в гиперпространство,[br]так как будет превышена предельная масса флота.[/center]
  WarningFleetFormationNoFromHyperspace	[center][crt]ВНИМАНИЕ![/crt] В грузовом или транспортном построении корабли могут выходить[br]из гиперпространства только в свое личное созвездие или на планеты анклава.[/center]
  WarningFleetOutLimitCombat	[center][crt]ВНИМАНИЕ![/crt] Для битвы вы исчерпали лимит массы кораблей.[/center]
  WarningCotlWait	[center][crt]ВНИМАНИЕ![/crt] Созвездие в режиме ожидания.[br]Подождите до начала активных действий.[/center]
  WarningCotlProtectSimple	[center][crt]ВНИМАНИЕ![/crt] Созвездие находится под защитой.[/center]
  WarningCotlProtect	[center][crt]ВНИМАНИЕ![/crt] Созвездие находится под защитой. Ваши корабли не могут выйти[br]из гиперпространства в это созвездие.[/center]
  WarningCotlProtectOnlyHome	[center][crt]ВНИМАНИЕ![/crt] Когда ваше созвездие находится под защитой, вы можете выходить кораблями[br]из гиперпространства только в свое личное созвездие или на планеты анклава.[/center]
  WarningCotlOnlyBase	[center][crt]ВНИМАНИЕ![/crt] Для данного созвездия, вы можете выходить кораблями[br]из гиперпространства только в свой личный сфере.[/center]
  WarningCotlOnlyRWH	[center][crt]ВНИМАНИЕ![/crt] Для данного созвездия, вы можете выходить кораблями[br]из гиперпространства только на открытые блуждающие червоточины.[/center]
  WarningCotlProtectNoCitadel	[center][crt]ВНИМАНИЕ![/crt] Когда ваше созвездие находится под защитой, то запрещено основывать цитадель.[/center]
  WarningDestroy	<p align='center'>Вы действительно хотите взорвать корабли?</p>
  WarningLeave	<p align='center'>Вы действительно хотите покинуть планету?</p>
  WarningBomb	<p align='center'>Вы действительно хотите аннигилировать эскадру?</p>"  
  WarningNoBuildMass	[center][crt]ВНИМАНИЕ![/crt] Построить новые корабли невозможно, так как[br]ваш флот будет превышать предельно допустимую массу.[/center]
  WarningNoBuildSupport	[crt]ВНИМАНИЕ![/crt] У вас отрицательный ресурсный баланс.[br]Чтобы строить корабли нужно иметь для снабжения\nзапас ресурсов в количестве	\n\n
  WarningNoBuildBattle	[crt]ВНИМАНИЕ![/crt] Вне столицы и цитадели во время битвы нельзя строить корабли.
  WarningNoBuildInfrBattle	[crt]ВНИМАНИЕ![/crt] Во время битвы на планете нельзя строить инфраструктуру.
  WarningNoBuildSDMUser	[crt]ВНИМАНИЕ![/crt] Строить за sdm можно только в личном созвездии.
  QueryPlanetShild	<p align='justify'>Планетарный щит – предназначен для защиты планеты и кораблей на её орбите в течение 24 часов. Первый час щит снижает урон, получаемый Вашими кораблями, на 80%. Каждый следующий час эффективность щита падает на 2%. Кроме того, время захвата планеты при включенном щите увеличивается в 5 раз.</p>\n\n<p align='left'>Стоимость включения	 200 egm.</p>\n\n<p align='left'>Вы уверены, что хотите включить планетарный щит для защиты планеты?</p>
  WarningNoEgm	Для выполнения данной операции у вас не хватает игровой валюты(egm). Вы хотите пополнить счет?
  WarningNoRes	[crt]ВНИМАНИЕ![/crt] Для выполнения данной операции у вас не хватает ресурсов.
  WarningCitadelDist	[crt]ВНИМАНИЕ![/crt] Цитадель не может быть основана ближе 20 секторов от столицы.
  WarningNoCaptureLvl	[center][crt]ВНИМАНИЕ![/crt] Вы не можете захватить данную планету, так как[br]количество атакующих штурмовиков должно быть не меньше уровня инфраструктуры планеты.[/center]
  WarningNoCaptureEmpire	[center][crt]ВНИМАНИЕ![/crt] Вы не можете захватить данную планету, так как[br]у Вас предельное количество планет в империи.[/center]
  WarningNoCaptureEnclave	[center][crt]ВНИМАНИЕ![/crt] Вы не можете захватить данную планету, так как[br]у Вас предельное количество планет в анклаве.[/center]
  WarningNoCaptureColony	[center][crt]ВНИМАНИЕ![/crt] Вы не можете захватить данную планету, так как[br]у Вас предельное количество колоний.[/center]
  WarningNoCapturePlanet	[center][crt]ВНИМАНИЕ![/crt] Вы не можете захватить данную планету, так как[br]у Вас предельное количество планет во всей империи.[/center]
  WarningNoMorePortal	[crt]ВНИМАНИЕ![crt] Только одно звено кораблей может проходить через портал.
  WarningMoveGravitor	[crt]ВНИМАНИЕ![/crt] Гравитационные возмущения не позволяют выйти на орбиту планеты.
  WarningMoveGravitorPulsar	[crt]ВНИМАНИЕ![/crt] Гравитационные возмущения не позволяют кораблям выйти на орбиту пульсара.
  WarningNoMoreCpt	[center][crt]ВНИМАНИЕ![/crt] Чтобы иметь больше одного флагмана нужно[br]активировать инжектор капитанов или контроля.[/center]
  WarningNoPortalCnt	[crt]ВНИМАНИЕ![/crt] Корабли не могут перейти через портал, так как их слишком много.
  WarningNoPortalOwner	[crt]ВНИМАНИЕ![/crt] Корабли не могут перейти через вражеский портал." 
  WarningNoLeaveAccupation	[crt]ВНИМАНИЕ![/crt] Вы не можете покинуть оккупированную планету.
  WarningNoRating	[center][crt]ВНИМАНИЕ![/crt] Вы не можете войти в созвездие, так как[br]ваши рейтинги сильно отличаются.[/center]
  WarningNoAccessCombat	[center][crt]ВНИМАНИЕ![/crt] Вы не можете участвовать в этой битве.[/center]
  WarningOpBattle	[center][crt]ВНИМАНИЕ![/crt] Во время битвы данная операция запрещена.[/center]
  WarningPathNotFound	[center][crt]ВНИМАНИЕ![/crt] Если маршрут не прокладывается на большое расстояние,[br]то скорее всего вам нужно сначала просмотреть весь предполагаемый маршрут,[br] для того чтобы загрузились нужные сектора.[/center]
  WarningBuildingNeedLargePlanet	[center][crt]ВНИМАНИЕ![/crt] Данную постройку можно построить только на обитаемых планетах.[/center]
  WarningBuildingNeedSmallPlanet	[center][crt]ВНИМАНИЕ![/crt] Данную постройку можно построить только на малых планетах.[/center]
  WarningBuildingLabAndModule	[center][crt]ВНИМАНИЕ![/crt] Запрещена постройка на одной планете лаборатории и сборочного комплекса.[/center]
  WarningNoMorePilot	[center][crt]ВНИМАНИЕ![/crt] Нельзя использовать более одного механика или навигатора.[/center]
  WarningNoCancelBuildFlagshipInRelocate	[center][crt]ВНИМАНИЕ![/crt] Запрещено отменять строительство флагмана[br]в режиме перераспределения технологий.[/center]
  WarningOutWarehouse	Не работает - вне склада.
  WarningNoMoreQuarkBase	[center][crt]ВНИМАНИЕ![/crt] Запрещено иметь больше одного гравитационного разрушителя.[/center]
  WarningNeedQuarkCore	[center][crt]ВНИМАНИЕ![/crt] Требуется [clr]<Val>[/clr] кварковых ядер.[/center]
  WarningNeedSingleQuarkCore	[center][crt]ВНИМАНИЕ![/crt] Требуется одно кварковое ядро.[/center]
  WarningNeedBattleMode	[center][crt]ВНИМАНИЕ![/crt] Разрушитель должен быть в боевом режиме.[/center]
  WarningNeedReloadReactor	[center][crt]ВНИМАНИЕ![/crt] Идет перезагрузка реактора.[/center]
  WarningCotlOpNoAccessIsDev	[center][crt]ВНИМАНИЕ![/crt] Операция запрещена, так как созвездие в режиме разработки.[/center]
  WarningNoMoveInPlacing	[center][crt]ВНИМАНИЕ![/crt] Во время расстановки запрещено движение кораблей.[/center]
  WarningNoGravWellRadiation	[center][crt]ВНИМАНИЕ![/crt] При радиации нельзя активировать гравитационный колодец.[/center]
  WarningNoOpEnemy	[center][crt]ВНИМАНИЕ![/crt] Даная операция невозможна, так как созвездие[br]блокируют вражеские корабли.[/center]
  WarningQuarkBasePortalLimit	[crt]ВНИМАНИЕ![/crt] Разрушитель можно портировать только в личное[br]созвездие, между планетами анклава или на орбиту цитадели.
  WarningAutoPilotOn	[center][clr]ВНИМАНИЕ![/clr] Активация пилотов.[/center]
  WarningAutoPilotOff	[center][clr]ВНИМАНИЕ![/clr] Пилоты отключены.[/center]
  ButBuyEgm	Пополнить счет
  LostQuery	Сервер не ответил на запрос" 
  NoCacheFlash	У вас отключено локальное хранилище, без которого невозможно играть.
  NoCacheFlashAIR	Чтобы продолжить вы должны войти в игру через сайт и включить локальное хранилище. После чего вы можете играть как в браузере так и в клиентской версии игры.
  FindHelp	Примеры	\n импорт созвездие гурт\n экспорт топлива объемом 10000... по цене 1...100 за 1000 ед\n\nДистанция поиска	 <font color='#ffff00'>500</font> секторов.\n
  FindError	 "Некорректный запрос.
  FindNotFound	 "Не найдено.
  Hint	hint
  GalaxyAward	Альянс, который честно и не нарушая правил игры захватил 80% галактики, получает весь банк в размере [clr]<Val>[/clr] WMR. Деньги перечисляются на кошелек лидера альянса.
  Zone0	Дальний космос
  Zone1	Враждебная зона
  Zone2	Умеренная зона
  Zone3	Защищенная зона
  ZoneModuleMul	Приход модулей
  ZoneRatingRange	Если разместить свое созвездие в этой зоне, то на вас сможет напасть игрок с рейтингом развития в диапазоне [clr]<Min>[/clr]...[clr]<Max>[/clr].
  ZoneRatingRangeAny	Если разместить свое созвездие в дальнем космосе, то на вас сможет напасть любой игрок."