ChangeCnt	Изменить количество
CotlSet	Параметры созвездия
MapEdit	Редактировать карту
MapSave	Сохранить карту
PowerMul	Сила кораблей (%)
ManufMul	Скорость производства (*)
LootMul	Лут (%)
LootForPlayerMul	Лут игрока (%)
MapUnload	Выгрузить карту
MapUnloadQuery	Вы действительно хотите выгрузить карту?
MapDelete	Удалить карту
MapDeleteQuery	Для удаления карты введите слово 'DELETE'
MapChangeOptions	Изменить настройки карты
MapChangeOptionsEx	Изменить настройки карты 2
MapChangeCode	Код
MapChangeConsumption	Потребление
MapChangeViewStat	Статистика
MapChangeOpsEnterShip	Корабли игрока могут войти в созвездие
MapChangeOpsEnterTransport	Транспорты игрока могут войти в созвездие
MapChangeOpsEnterFlagship	Флагманы игрока могут войти в созвездие
MapChangeOpsLeaveShip	Корабли игрока могут покинуть созвездие
MapChangeOpsLeaveTransport	Транспорты игрока могут покинуть созвездие
MapChangeOpsLeaveFlagship	Флагманы игрока могут покинуть созвездие
MapChangeOpsBuildShip	Строительство кораблей
MapChangeOpsBuildFlagship	Строительство флагманов
MapChangeOpsBuildWarBase	Строительство военных баз
MapChangeOpsBuildSciBase	Строительство научных станций
MapChangeOpsBuildShipyard	Строительство верфей
MapChangeOpsRelGloablOff	Договора не работают внутри созвездия
MapChangeOpsItemToHyperspace	Вывоз товаров из созвездия
MapChangeOpsBuilding	Строительство зданий
MapChangeOpsViewAll	Просмотр для всех
MapChangeOpsJumpRadius	Дальность перелета
MapChangeOpsModuleProduction	Объем производства товаров (*)
MapChangeOpsCostBuildLvl	Стоимость постройки инфраструктуры (%)
MapChangeOpsSpeedCapture	Время захвата планет 
MapChangeOpsSpeedBuild	Время постройки кораблей (%)
MapChangeOpsRestartCooldown	Перезагрузка созвездия (в минутах)
MapChangeOpsProtectCooldown	Время защиты (в минутах)
MapChangeOpsStartTime	Запуск (созвездия, БЧТ) (в минутах)
MapChangeOpsPulsarActive	Активность (пульсаров, БЧТ) (в минутах) 
MapChangeOpsPulsarPassive	Пассивность (пульсаров, БЧТ) (в минутах) 
MapChangeOpsPulsarEnterActive	Войти в созвездие можно только когда пульсар активен
MapChangeOpsNeutralBuild	Нейтральные корабли
MapChangeOpsKlingBuild	Клисаны
MapChangeOpsWormholeLong	Долгие червоточины
MapChangeOpsWormholeFast	Быстрые червоточины
MapChangeOpsWormholeRoam	Блуждающие червоточины
MapChangeOpsEnterSingleInvader	Входить может только один штурмовик 
MapChangeOpsWin	Цель 
MapChangeOpsWinOccupyCitadel	Оккупация 
MapChangeOpsWinMaxPlanet	Планеты 
MapChangeOpsWinCtrlCitadel	Контроль цитаделей 
MapChangeOpsWinMaxEnclave	Доминирующий анклав
MapChangeOpsRewardExp	Опыт 
MapChangeOpsWinScore	Очков для победы 
MapChangeOpsMaxRating	Максимальный рейтинг 
MapChangeOpsPriceEnterType	Цена входа 
MapChangeOpsPriceCaptureType	Цена захвата 
MapChangeOpsPriceCaptureEgm	Цена захвата в egm 
MapChangeOpsEnclave	Анклав
MapChangeOpsPlanetShield	Планетарный щит
MapChangeOpsPlayerExp	Опыт за корабли игроков
MapChangeOpsTeamOwner	Команда владельцев
MapChangeOpsTeamEnemy	Команда врагов
MapChangeSize	Изменить размер карты
MapChangeRandomizeNeutral	Рандомезировать нейтралов
MapChangeRandomizeNeutralQuery	На основании расы планеты спавнятся нейтральные корабли соответствующей расы. Вы уверены, что хотите случайно назначить расу каждой планете? Все нейтральные корабли будут удалены.
MapChangeRandomizeElement	Рандомезировать специализацию
MapChangeRandomizeElementQuery	Вы уверены, что хотите случайно назначить специализацию каждой захватываемой планете?
MapChangeSizeLeft	Слева
MapChangeSizeRight	Справа
MapChangeSizeTop	Сверху
MapChangeSizeBottom	Снизу
Add	Добавить 
ButAdd	ДОБАВИТЬ
AddPlanet	Создать планетоид
EditPlanet	Изменить планетоид
DeletePlanet	Удалить планетоид
DeletePlanetQuery	Вы действительно хотите удалить планетоид?
EditPlanetName	Изменить описание планетоида
EditPlanetSpawn	Спавн звеньев
SpawnSave	Изменить
SpawnPageBase	Общие
SpawnPageGroup	Звенья
SpawnPageEq	Снаряжение
SpawnPageFind	Поиск
SpawnPageDelete	Удаление
SpawnEmpty	Пропуск
SpawnNoToBattle	Пхд
SpawnCnt	Кол-во
SpawnAtk	Атака
SpawnRoute	След
SpawnKey	Ключ
SpawnKeyAnd	Маска ключа
SpawnKeyEq	Проверка ключа
SpawnFindRadius	Радиус
SpawnDeleteOn	Удалять при повреждении
SpawnDeleteNoFlagship	Удалять при отсутствии флагмана или разрушителя
SpawnDeleteProc	Повреждения (%)
SpawnDeleteGroup	Кол-во звеньев
SpawnPeriod	Период (в секундах)
SpawnPeriodIfEnemy	Период если враг
SpawnPeriodRnd	Разброс (в секундах)
SpawnTarget	Цель
SpawnTargetNone	
SpawnTargetSelf	Текущая
SpawnTargetTgt	Целевая
SpawnEq	Оборудование
SpawnCargo	Трюм
SpawnDelete	Удалить
SpawnCodeError	Ошибка разбора кода. Прежде чем менять исправьте код.
SpawnCodeErrorNotNew	Не найдена строка в коде, которая указывает начало нового определения. Прежде чем менять исправьте код.
Name	Название
Desc	Описание
OpenWormhole	Открыть червоточину
CloseWormhole	Закрыть червоточину
OpenPlanet	Открыть планетоид
AddShip	Создать звено кораблей
EditShip	Изменить звено кораблей
DeleteShip	Удалить звено кораблей
DeleteShipQuery	Вы действительно хотите удалить звено кораблей?
EditOrbitItem	Изменить товар 
DeleteOrbitItem	Удалить товар 
DeleteOrbitItemQuery	Вы действительно хотите удалить товар? 
Add	Создать
Edit	Изменить
ButEdit	ИЗМЕНИТЬ
PlanetType	Тип
PlanetSun	Звезда
PlanetPulsar	Пульсар
PlanetWormhole	Червоточина
PlanetWormholeRoam	Блуждающая червоточина
PlanetAsteroid	Карликовая планета
PlanetGigant	Газовый гигант
PlanetSmall	Малая планета
PlanetLarge	Обитаемая планета
PlanetRich	Радужный мир
PlanetPageMain	Основные
PlanetPageAdd	Дополнительные
PlanetTimer	Таймер
PlanetStabilizer	Стабилизация
ShipType	Тип
ItemType	Тип 
Owner	Владелец
OwnerNone	Отсутствует
OwnerAI0	AI 1
OwnerAI1	AI 2
OwnerAI2	AI 3
OwnerAI3	AI 4
CptAI0	CptAI 1
CptAI1	CptAI 2
CptAI2	CptAI 3
Level	Инфраструктура
Race	Раса
Cnt	Количество
Module	Модули
Fuel	Топливо
BuildItem	Специализация
BuildItemNone	Отсутствует
ProtectRemove	Снять защиту
UpdateMap	Обновить карту
Eq	Оборудование
EqCnt	Кол-во оборудования
Cargo	Товар
CargoCnt	Кол-во товара
OwnerOptions	Параметры AI
OwnerTech	Технологии AI 
ArrivalAtk	Место высадки для нападения 
ArrivalDef	Место высадки для защиты 
Capture	Возможно захватить планету 
NoCapture	Нельзя захватить планету (специальные правила)
NoMove	Нельзя выйти на орбиту планеты
PlanetFindMask	Ключ
AutoRefuel	Заправка 
AutoBuild	Автоматическая постройка кораблей 
AutoBuildType	Тип 
AutoBuildCnt	Количество 
AutoBuildTime	Время 
AutoBuildWait	Ожидание 
BuildShipNone	Отсутствует 
FleetAddShip	Добавить корабли
FormTeamRelCaption	Отношения команд
Team	Команда
FormItemImgCpation	Изображения итемов
FormItemManagerCpation	Редактор итемов
EditItemCaption	Параметры итема
ItemName	Название
ItemDesc	Описание
ItemSlotType	Слот
ItemLvl	Уровень
ItemStackMax	Размер стека
ChangeCotlPos	Перенести созвездие
ErrorCotlInGameMode	[crt]ОШИБКА![/crt] Созвездие в игровом режиме.
ErrorCotlInEditMode	[crt]ОШИБКА![/crt] Созвездие в режиме редактирования.
ErrorCotlInDevelopment	[crt]ОШИБКА![/crt] Созвездие в режиме разработки.
VisAll	Просмотр для всех
ImportIfEnemy	Импортировать если враг
AutoProgress	Автоматическое развитие
PlayerControl	Игрок может управлять кораблями
SpaceStyleCaption	Оформление созвездия
SpaceStyleMain	Общие
SpaceStyleBGLayer1	Слой 1
SpaceStyleBGLayer2	Слой 2
SpaceStyleBGLayer3	Слой 3
SpaceStyleBGLayer4	Слой 4
SpaceStyleBGImg1	Спрайт 1
SpaceStyleBGImg2	Спрайт 2
SpaceStyleBGImg3	Спрайт 3
SpaceStyleBGImg4	Спрайт 4
SpaceStyleBGClr1	Цвет спрайта 1
SpaceStyleBGClr2	Цвет спрайта 2
SpaceStyleBGClr3	Цвет спрайта 3
SpaceStyleBGClr4	Цвет спрайта 4
SpaceStyleSize	Размер
SpaceStyleOff	Смещение
SpaceStyleZ	Z
SpaceStyleBeginLayer	Начало
SpaceStyleFillColor	Цвет заполнения
SpaceStyleFillImg	Спрайт заполнения
SpaceStyleColorGrid	Цвет секторов
SpaceStyleColorCoord	Цвет координат
SpaceStyleColorTrade	Цвет торговых маршрутов
SpaceStyleColorRoute	Цвет военных маршрутов
SpaceStyleFlipX	FlipX
SpaceStyleFlipY	FlipY
SpaceStyleRotate	Rotate
FormQuestManagerCpation	Редактор квестов
StatCaption	Статистика
StatSecEmptyCnt	Пустых секторов
StatPlanetCnt	Всего планетоидов
StatPulsarCnt	Пульсаров
StatSunCnt	Звезд
StatWormholeCnt	Червоточин
StatGigantCnt	Газовых гигантов
StatTiniCnt	Карликовых планет
StatRichCnt	Радужных миров
StatLiveCnt	Обитаемых планет
StatSmallCnt	Малых планет
StatOwner	Владелец
StatOwnerNeutral	Нейтральный
StatGoodsPlanet	Товар на планетах
StatGoodsShip	Товар на кораблях или орбите планет
StatShips	Кораблей
StatMaxSize	Размер карты
StatShipKeys	Ключи кораблей
ConsumptionCaption	Потребление